"Dato";"Tekst";"Beløb";"Saldo";"Status";"Afstemt"
"02.07.2012";"McDonald's         71155";"-179,50";"8.317,25";"Udført";"Nej"
"02.07.2012";"Automatudb. 0400-6674";"-500,00";"7.817,25";"Udført";"Nej"
"02.07.2012";"VDK USD     9,99";"-60,75";"7.756,50";"Udført";"Nej"
"02.07.2012";"VDK USD    22,16";"-134,74";"7.621,76";"Udført";"Nej"
"02.07.2012";"VDK DKK    99,00";"-99,00";"7.522,76";"Udført";"Nej"
"02.07.2012";"Candy Megastore Sw 81656";"-141,50";"7.381,26";"Udført";"Nej"
"02.07.2012";"Player ApS         61108";"-400,00";"6.981,26";"Udført";"Nej"
"02.07.2012";"Faraos Cigarer     71232";"-530,00";"6.451,26";"Udført";"Nej"
"02.07.2012";"Faraos Cigarer     71253";"-701,00";"5.750,26";"Udført";"Nej"
"02.07.2012";"Lemontblanc        96426";"-181,00";"5.569,26";"Udført";"Nej"
"02.07.2012";"KØBMANDSGÅRDEN     75213";"-174,15";"5.395,11";"Udført";"Nej"
"02.07.2012";"LISELEJE BAGEREN A 49691";"-102,00";"5.293,11";"Udført";"Nej"
"02.07.2012";"onfone.dk          69829";"-123,75";"5.169,36";"Udført";"Nej"
"02.07.2012";"Shell Service      01746";"-334,19";"4.835,17";"Udført";"Nej"
"02.07.2012";"FOCUS ØSTER FARIMA 63587";"-231,25";"4.603,92";"Udført";"Nej"
"02.07.2012";"PULCINELLA PIZZARI 42460";"-154,00";"4.449,92";"Udført";"Nej"
"02.07.2012";"TV 2/DANMARK       19550";"-19,00";"4.430,92";"Udført";"Nej"
"02.07.2012";"Den Lille Butik    21152";"-53,00";"4.377,92";"Udført";"Nej"
"02.07.2012";"Monsson Accessoriz 11053";"-84,00";"4.293,92";"Udført";"Nej"
"02.07.2012";"Player ApS         61459";"-800,00";"3.493,92";"Udført";"Nej"
"02.07.2012";"BRUNO & JOEL       16574";"-900,00";"2.593,92";"Udført";"Nej"
"02.07.2012";"Irma Nørre Voldg.  10023";"-345,50";"2.248,42";"Udført";"Nej"
"03.07.2012";"VDK DKK    99,00";"-99,00";"2.149,42";"Udført";"Nej"
"03.07.2012";"7-Eleven B 21      69195";"-57,85";"2.091,57";"Udført";"Nej"
"03.07.2012";"Irma Codanhus 2301 33556";"-87,00";"2.004,57";"Udført";"Nej"
"03.07.2012";"CONDITORI LA GLACE 30171";"-694,00";"1.310,57";"Udført";"Nej"
"03.07.2012";"FOCUS ØSTER FARIMA 64316";"-110,50";"1.200,07";"Udført";"Nej"
"03.07.2012";"King tut pizza     55934";"-63,00";"1.137,07";"Udført";"Nej"
"03.07.2012";"McDonald's         70386";"-190,50";"946,57";"Udført";"Nej"
"04.07.2012";"Automatudb. 6737-2266";"-1.300,00";"-353,43";"Udført";"Nej"
"04.07.2012";"FOCUS ØSTER FARIMA 64857";"-98,45";"-451,88";"Udført";"Nej"
"04.07.2012";"Paradis Trianglen  63365";"-200,00";"-651,88";"Udført";"Nej"
"04.07.2012";"Irma Oslo Plads    47013";"-729,00";"-1.380,88";"Udført";"Nej"
"05.07.2012";"TDC Yousee         65393";"-39,70";"-1.420,58";"Udført";"Nej"
"05.07.2012";"VDK DKK   997,19";"-997,19";"-2.417,77";"Udført";"Nej"
"05.07.2012";"KILDESKOVSHALLEN   82719";"-150,00";"-2.567,77";"Udført";"Nej"
"05.07.2012";"Laviula Company Ap 17397";"-70,00";"-2.637,77";"Udført";"Nej"
"05.07.2012";"Shell Service-1173 02172";"-454,17";"-3.091,94";"Udført";"Nej"
"05.07.2012";"AMAGER-STRAND IS O 03502";"-50,00";"-3.141,94";"Udført";"Nej"
"05.07.2012";"Ovf. tilbage";"17.500,00";"14.358,06";"Udført";"Nej"
"05.07.2012";"Ovf. til SPG";"-1.000,00";"13.358,06";"Udført";"Nej"
"05.07.2012";"Byens Orientalske  60816";"-17,00";"13.341,06";"Udført";"Nej"
"05.07.2012";"Ovf. til Mathilde";"-500,00";"12.841,06";"Udført";"Nej"
"05.07.2012";"FOCUS ØSTER FARIMA 65451";"-78,45";"12.762,61";"Udført";"Nej"
"05.07.2012";"TDC Yousee         97634";"-39,70";"12.722,91";"Udført";"Nej"
"06.07.2012";"FONA AFD. FS/110   69782";"-184,85";"12.538,06";"Udført";"Nej"
"06.07.2012";"FONA AFD. FS/110   03432";"-179,95";"12.358,11";"Udført";"Nej"
"06.07.2012";"FONA AFD. FS/110   26688";"-249,00";"12.109,11";"Udført";"Nej"
"06.07.2012";"Morten Holm        01548";"-81,00";"12.028,11";"Udført";"Nej"
"06.07.2012";"Faraos Cigarer     71792";"-55,00";"11.973,11";"Udført";"Nej"
"06.07.2012";"LABCPH             07792";"-500,00";"11.473,11";"Udført";"Nej"
"06.07.2012";"Irma Codanhus 2301 04704";"-100,00";"11.373,11";"Udført";"Nej"
"06.07.2012";"Irma Codanhus 2301 35979";"-150,00";"11.223,11";"Udført";"Nej"
"06.07.2012";"FOCUS ØSTER FARIMA 65627";"-51,00";"11.172,11";"Udført";"Nej"
"06.07.2012";"Toscana Due        13130";"-168,00";"11.004,11";"Udført";"Nej"
"09.07.2012";"Sticks N Sushi     63531";"-187,00";"10.817,11";"Udført";"Nej"
"09.07.2012";"Englebørn          29099";"-349,00";"10.468,11";"Udført";"Nej"
"09.07.2012";"CARRE COPENHAGEN   17202";"-390,00";"10.078,11";"Udført";"Nej"
"09.07.2012";"Holms bager        40410";"-68,00";"10.010,11";"Udført";"Nej"
"09.07.2012";"Lemontblanc        97276";"-60,00";"9.950,11";"Udført";"Nej"
"09.07.2012";"Vedels             96605";"-52,00";"9.898,11";"Udført";"Nej"
"09.07.2012";"Sidewalk           20719";"-1.500,00";"8.398,11";"Udført";"Nej"
"09.07.2012";"Parkering Kbh VB-B 38223";"-7,50";"8.390,61";"Udført";"Nej"
"09.07.2012";"Shawarma ApS       88749";"-187,00";"8.203,61";"Udført";"Nej"
"09.07.2012";"Mcdonalds Fr.bergg 78490";"-30,00";"8.173,61";"Udført";"Nej"
"09.07.2012";"Illums Bolighus    00720";"-998,00";"7.175,61";"Udført";"Nej"
"09.07.2012";"Vedels             96664";"-108,00";"7.067,61";"Udført";"Nej"
"09.07.2012";"FOCUS ØSTER FARIMA 66167";"-9,95";"7.057,66";"Udført";"Nej"
"09.07.2012";"FOCUS ØSTER FARIMA 66349";"-22,00";"7.035,66";"Udført";"Nej"
"09.07.2012";"IRMA RYESGADE 60   42490";"-517,00";"6.518,66";"Udført";"Nej"
"09.07.2012";"emmerys            66252";"-124,50";"6.394,16";"Udført";"Nej"
"09.07.2012";"FOCUS ØSTER FARIMA 66768";"-54,90";"6.339,26";"Udført";"Nej"
"09.07.2012";"emmerys            66429";"-90,00";"6.249,26";"Udført";"Nej"
"09.07.2012";"Irma Østerbrog.52  25956";"-138,50";"6.110,76";"Udført";"Nej"
"09.07.2012";"ORION PIZZABAR     80497";"-76,00";"6.034,76";"Udført";"Nej"
"10.07.2012";"Automatudb. 2115-3862";"-1.000,00";"5.034,76";"Udført";"Nej"
"10.07.2012";"CONDITORI LA GLACE 48449";"-587,00";"4.447,76";"Udført";"Nej"
"10.07.2012";"FONA AFD. FS/110   74407";"-799,85";"3.647,91";"Udført";"Nej"
"10.07.2012";"Morten Holm        02698";"-37,00";"3.610,91";"Udført";"Nej"
"10.07.2012";"Noa Noa Østergade  26554";"-223,00";"3.387,91";"Udført";"Nej"
"10.07.2012";"Parkering Kbh IØ   25909";"-15,50";"3.372,41";"Udført";"Nej"
"11.07.2012";"VDK DKK    29,00";"-29,00";"3.343,41";"Udført";"Nej"
"11.07.2012";"Parkering Kbh IØ   24122";"-20,50";"3.322,91";"Udført";"Nej"
"11.07.2012";"Parkering Kbh IØ   25921";"-15,50";"3.307,41";"Udført";"Nej"
"11.07.2012";"Irma Oslo Plads    39596";"-1.121,50";"2.185,91";"Udført";"Nej"
"11.07.2012";"TIVOLI A/S         16312";"-1.950,00";"235,91";"Udført";"Nej"
"12.07.2012";"7-Eleven B 83      46429";"-126,50";"109,41";"Udført";"Nej"
"12.07.2012";"emmerys            67039";"-96,00";"13,41";"Udført";"Nej"
"12.07.2012";"Lagkagehuset Frede 19768";"-168,00";"-154,59";"Udført";"Nej"
"12.07.2012";"FOCUS ØSTER FARIMA 68085";"-56,35";"-210,94";"Udført";"Nej"
"12.07.2012";"GAMES WORKSHOP     61363";"-235,00";"-445,94";"Udført";"Nej"
"12.07.2012";"McDonald's         95154";"-326,50";"-772,44";"Udført";"Nej"
"13.07.2012";"KØBMANDSGÅRDEN     83358";"-620,25";"-1.392,69";"Udført";"Nej"
"16.07.2012";"LISELEJE BAGEREN A 09884";"-100,00";"-1.492,69";"Udført";"Nej"
"16.07.2012";"Q8 Service - 8060  24792";"-81,00";"-1.573,69";"Udført";"Nej"
"16.07.2012";"Noa Noa Østergade  27164";"-149,50";"-1.723,19";"Udført";"Nej"
"16.07.2012";"Noa Noa            60870";"-149,50";"-1.872,69";"Udført";"Nej"
"16.07.2012";"Magasin, Kgs Nytor 12427";"-300,00";"-2.172,69";"Udført";"Nej"
"16.07.2012";"IRMA RYESGADE 60   47514";"-240,50";"-2.413,19";"Udført";"Nej"
"16.07.2012";"Fiskeridirektorat  11478";"-200,00";"-2.613,19";"Udført";"Nej"
"16.07.2012";"Q8 Service - 8060  10200";"-532,81";"-3.146,00";"Udført";"Nej"
"16.07.2012";"FOCUS ØSTER FARIMA 69396";"-56,45";"-3.202,45";"Udført";"Nej"
"16.07.2012";"FOCUS ØSTER FARIMA 69599";"-73,20";"-3.275,65";"Udført";"Nej"
"16.07.2012";"Sticks N Sushi     84634";"-399,00";"-3.674,65";"Udført";"Nej"
"16.07.2012";"emmerys            68070";"-114,00";"-3.788,65";"Udført";"Nej"
"16.07.2012";"Jagt- og Fiskerima 29392";"-1.149,00";"-4.937,65";"Udført";"Nej"
"16.07.2012";"Noa Noa            54702";"149,50";"-4.788,15";"Udført";"Nej"
"16.07.2012";"Magasin, Kgs Nytor 21501";"-575,00";"-5.363,15";"Udført";"Nej"
"16.07.2012";"Morten Holm        04380";"-37,00";"-5.400,15";"Udført";"Nej"
"16.07.2012";"CINEMAXX FISKETORV 26994";"-119,75";"-5.519,90";"Udført";"Nej"
"16.07.2012";"Hennes & Mauritz A 91459";"-337,95";"-5.857,85";"Udført";"Nej"
"16.07.2012";"BAHNE FISKETORVET  35113";"-149,95";"-6.007,80";"Udført";"Nej"
"16.07.2012";"Fisketorvet Føtex  66595";"-425,92";"-6.433,72";"Udført";"Nej"
"17.07.2012";"Toscana Due        13877";"-80,00";"-6.513,72";"Udført";"Nej"
"17.07.2012";"E BILLET A/S       85161";"-266,72";"-6.780,44";"Udført";"Nej"
"17.07.2012";"Scandlines I/S Dan 17761";"-360,00";"-7.140,44";"Udført";"Nej"
"19.07.2012";"VDK SEK   136,00";"-118,88";"-7.259,32";"Udført";"Nej"
"19.07.2012";"Nespresso Danmark  77383";"-658,00";"-7.917,32";"Udført";"Nej"
"19.07.2012";"Lemontblanc        98492";"-60,00";"-7.977,32";"Udført";"Nej"
"19.07.2012";"The Bagel co.      25354";"-116,00";"-8.093,32";"Udført";"Nej"
"19.07.2012";"DSB NETBUTIK       31412";"-402,00";"-8.495,32";"Udført";"Nej"
"19.07.2012";"billetdk.dk        13790";"-759,21";"-9.254,53";"Udført";"Nej"
"20.07.2012";"VDK SEK   969,09";"-858,70";"-10.113,23";"Udført";"Nej"
"20.07.2012";"Taxa 4 X 35        16728";"-90,00";"-10.203,23";"Udført";"Nej"
"20.07.2012";"Reinh. van Hauen   56954";"-79,45";"-10.282,68";"Udført";"Nej"
"20.07.2012";"FOCUS ØSTER FARIMA 70835";"-39,90";"-10.322,58";"Udført";"Nej"
"20.07.2012";"GET OUT AND FISH A 15924";"-399,00";"-10.721,58";"Udført";"Nej"
"20.07.2012";"Jagt- og Fiskerima 29644";"-615,00";"-11.336,58";"Udført";"Nej"
"20.07.2012";"Irma Nørre Voldg.  40510";"-531,42";"-11.868,00";"Udført";"Nej"
"20.07.2012";"ROMA PIZZERIA      19877";"-158,00";"-12.026,00";"Udført";"Nej"
"20.07.2012";"FONA AFD. FS/110   74875";"-379,85";"-12.405,85";"Udført";"Nej"
"23.07.2012";"BURGER KING        70725";"-178,00";"-12.583,85";"Udført";"Nej"
"23.07.2012";"McDonald's         96125";"-168,50";"-12.752,35";"Udført";"Nej"
"23.07.2012";"FOCUS ØSTER FARIMA 71387";"-202,45";"-12.954,80";"Udført";"Nej"
"23.07.2012";"onfone.dk          16548";"-50,00";"-13.004,80";"Udført";"Nej"
"23.07.2012";"Parkering Kbh IØ   26323";"-10,50";"-13.015,30";"Udført";"Nej"
"23.07.2012";"Isbjerget Tivoli   68939";"-80,00";"-13.095,30";"Udført";"Nej"
"23.07.2012";"Svaneke Ismejeri & 06477";"-45,00";"-13.140,30";"Udført";"Nej"
"23.07.2012";"VDK DKK    39,00";"-39,00";"-13.179,30";"Udført";"Nej"
"23.07.2012";"Pigernes Verden V/ 15173";"-200,00";"-13.379,30";"Udført";"Nej"
"23.07.2012";"FRILUFTSLAND A/S   10481";"-158,00";"-13.537,30";"Udført";"Nej"
"23.07.2012";"Fuglsang & Co      11553";"-99,00";"-13.636,30";"Udført";"Nej"
"23.07.2012";"Faraos Cigarer     73228";"-509,00";"-14.145,30";"Udført";"Nej"
"23.07.2012";"Lemontblanc        98777";"-146,00";"-14.291,30";"Udført";"Nej"
"23.07.2012";"IRMA RYESGADE 60   54096";"-268,50";"-14.559,80";"Udført";"Nej"
"24.07.2012";"Svaneke Ismejeri & 06737";"-180,00";"-14.739,80";"Udført";"Nej"
"24.07.2012";"Paris";"-3.000,00";"-17.739,80";"Udført";"Nej"
"24.07.2012";"Den Glade Pingvin  05409";"-562,00";"-18.301,80";"Udført";"Nej"
"24.07.2012";"McDonald's         73858";"-254,00";"-18.555,80";"Udført";"Nej"
"25.07.2012";"Automatudb. 5501-1541";"-500,00";"-19.055,80";"Udført";"Nej"
"25.07.2012";"Shell Service-1520 07727";"-726,11";"-19.781,91";"Udført";"Nej"
"25.07.2012";"STOREBÆLT          47301";"-230,00";"-20.011,91";"Udført";"Nej"
"26.07.2012";"VDK DKK    18,00";"-18,00";"-20.029,91";"Udført";"Nej"
"26.07.2012";"STOREBÆLT          72222";"-230,00";"-20.259,91";"Udført";"Nej"
"27.07.2012";"McDonald's         58526";"-118,00";"-20.377,91";"Udført";"Nej"
"27.07.2012";"TDC Yousee         32295";"-39,70";"-20.417,61";"Udført";"Nej"
"27.07.2012";"Statoil - 10383    63301";"-809,14";"-21.226,75";"Udført";"Nej"
"27.07.2012";"7-Eleven B 15      37674";"-40,00";"-21.266,75";"Udført";"Nej"
"27.07.2012";"Sticks N Sushi     14515";"-227,00";"-21.493,75";"Udført";"Nej"
"27.07.2012";"Irma Østerbrog.52  30825";"-146,50";"-21.640,25";"Udført";"Nej"
"27.07.2012";"FOCUS ØSTER FARIMA 73316";"-57,95";"-21.698,20";"Udført";"Nej"
"27.07.2012";"Reinh. van Hauen   58116";"-92,61";"-21.790,81";"Udført";"Nej"
"27.07.2012";"H & M              64379";"-298,00";"-22.088,81";"Udført";"Nej"
"27.07.2012";"Delizia Pizza      26053";"-174,00";"-22.262,81";"Udført";"Nej"
"27.07.2012";"Candy Megastore Sw 91137";"-133,00";"-22.395,81";"Udført";"Nej"
"30.07.2012";"7-Eleven B 21      69295";"-18,95";"-22.414,76";"Udført";"Nej"
"30.07.2012";"onfone.dk          75881";"-25,00";"-22.439,76";"Udført";"Nej"
"30.07.2012";"Parkering Kbh IØ   78053";"-10,50";"-22.450,26";"Udført";"Nej"
"30.07.2012";"Hennes & Mauritz   48283";"-377,95";"-22.828,21";"Udført";"Nej"
"30.07.2012";"Lisbeth Dahl       58857";"-77,50";"-22.905,71";"Udført";"Nej"
"30.07.2012";"Faraos Cigarer     73716";"-23,00";"-22.928,71";"Udført";"Nej"
"30.07.2012";"Jagt- og Fiskerima 30002";"-238,00";"-23.166,71";"Udført";"Nej"
"30.07.2012";"Irma Nørre Voldg.  13328";"-428,50";"-23.595,21";"Udført";"Nej"
"30.07.2012";"Day                06261";"-329,70";"-23.924,91";"Udført";"Nej"
"30.07.2012";"Lemontblanc        99332";"-120,00";"-24.044,91";"Udført";"Nej"
"30.07.2012";"FOCUS ØSTER FARIMA 73993";"-91,45";"-24.136,36";"Udført";"Nej"
"30.07.2012";"Elgiganten 3031    89443";"-1.623,00";"-25.759,36";"Udført";"Nej"
"30.07.2012";"emmerys            70987";"-1,05";"-25.760,41";"Udført";"Nej"
"30.07.2012";"emmerys            70989";"-105,00";"-25.865,41";"Udført";"Nej"
"30.07.2012";"FOCUS ØSTER FARIMA 74208";"-49,30";"-25.914,71";"Udført";"Nej"
"30.07.2012";"IRMA RYESGADE 60   98315";"-279,50";"-26.194,21";"Udført";"Nej"
"30.07.2012";"Lån til SPG budget";"-18.000,00";"-44.194,21";"Udført";"Nej"
"30.07.2012";"Mormor's gave";"-1.000,00";"-45.194,21";"Udført";"Nej"
"30.07.2012";"VN45269";"-705,00";"-45.899,21";"Udført";"Nej"
"30.07.2012";"KBL";"-300,00";"-46.199,21";"Udført";"Nej"
"30.07.2012";"Nordisk Film Bio   06601";"-176,63";"-46.375,84";"Udført";"Nej"
"30.07.2012";"Imperial           10367";"-55,00";"-46.430,84";"Udført";"Nej"
"30.07.2012";"Day                06395";"-134,70";"-46.565,54";"Udført";"Nej"
"30.07.2012";"FONA AFD. FS/110   78510";"-199,80";"-46.765,34";"Udført";"Nej"
"30.07.2012";"Lemontblanc        99455";"-65,00";"-46.830,34";"Udført";"Nej"
"30.07.2012";"Irma Oslo Plads    47699";"-551,00";"-47.381,34";"Udført";"Nej"
"31.07.2012";"budget";"-20.000,00";"-67.381,34";"Udført";"Nej"
"31.07.2012";"Fluefisker Ulnits";"-100,00";"-67.481,34";"Udført";"Nej"
"31.07.2012";"VDK USD     9,99";"-61,57";"-67.542,91";"Udført";"Nej"
"31.07.2012";"VDK DKK    99,00";"-99,00";"-67.641,91";"Udført";"Nej"
"31.07.2012";"VDK DKK    99,00";"-99,00";"-67.740,91";"Udført";"Nej"
"31.07.2012";"Lønoverførsel";"31.537,14";"-36.203,77";"Udført";"Nej"
"31.07.2012";"Ovf. Jette løn";"40.000,00";"3.796,23";"Udført";"Nej"
"31.07.2012";"Børnepenge";"6.200,00";"9.996,23";"Udført";"Nej"
"31.07.2012";"Ovf. til budget";"-12.700,00";"-2.703,77";"Udført";"Nej"
"31.07.2012";"Lommepenge-Mathilde";"-500,00";"-3.203,77";"Udført";"Nej"
"31.07.2012";"Lommepenge-Jette";"-3.000,00";"-6.203,77";"Udført";"Nej"
"31.07.2012";"Lommepenge - Jon";"-3.000,00";"-9.203,77";"Udført";"Nej"
"31.07.2012";"Shell Service-1189 10575";"-391,84";"-9.595,61";"Udført";"Nej"
"31.07.2012";"Super Spar         72259";"-180,99";"-9.776,60";"Udført";"Nej"
"31.07.2012";"Mejeriforeningen   79646";"-385,00";"-10.161,60";"Udført";"Nej"
"31.07.2012";"Mejeriforeningen   80792";"-385,00";"-10.546,60";"Udført";"Nej"
"31.07.2012";"FDB Kvickly Freder 16772";"-664,15";"-11.210,75";"Udført";"Nej"
"01.08.2012";"TV 2/DANMARK       62072";"-19,00";"-11.229,75";"Udført";"Nej"
"01.08.2012";"onfone.dk          39024";"-123,75";"-11.353,50";"Udført";"Nej"
"01.08.2012";"Asserbo kiosk I/S  45568";"-143,00";"-11.496,50";"Udført";"Nej"
"01.08.2012";"KØBMANDSGÅRDEN     17909";"-560,25";"-12.056,75";"Udført";"Nej"
"02.08.2012";"VDK DKK    39,00";"-39,00";"-12.095,75";"Udført";"Nej"
"02.08.2012";"LISELEJE BAGEREN A 55277";"-138,00";"-12.233,75";"Udført";"Nej"
"02.08.2012";"Fakta 392          55684";"-246,35";"-12.480,10";"Udført";"Nej"
"02.08.2012";"KØBMANDSGÅRDEN     97306";"-382,37";"-12.862,47";"Udført";"Nej"
"03.08.2012";"VDK DKK    39,00";"-39,00";"-12.901,47";"Udført";"Nej"
"03.08.2012";"LISELEJE BAGEREN A 47687";"-40,00";"-12.941,47";"Udført";"Nej"
"03.08.2012";"Paradis Tisvildele 21289";"-200,00";"-13.141,47";"Udført";"Nej"
"03.08.2012";"Pink               04177";"-150,00";"-13.291,47";"Udført";"Nej"
"03.08.2012";"KØBMANDSGÅRDEN     18883";"-331,00";"-13.622,47";"Udført";"Nej"
"05.08.2012";"Ovf. tilbage";"5.000,00";"-8.622,47";"Udført";"Nej"
"06.08.2012";"LISELEJE BAGEREN A 55572";"-97,50";"-8.719,97";"Udført";"Nej"
"06.08.2012";"Copenhagen Histori 01493";"-320,00";"-9.039,97";"Udført";"Nej"
"06.08.2012";"Familieboden       14949";"-100,00";"-9.139,97";"Udført";"Nej"
"06.08.2012";"The Bagel co.      27029";"-116,00";"-9.255,97";"Udført";"Nej"
"06.08.2012";"Lemontblanc        00146";"-60,00";"-9.315,97";"Udført";"Nej"
"06.08.2012";"FOCUS ØSTER FARIMA 76822";"-64,40";"-9.380,37";"Udført";"Nej"
"06.08.2012";"Vedels             97171";"-90,00";"-9.470,37";"Udført";"Nej"
"06.08.2012";"Automatudb. 3121-83 4315";"-700,00";"-10.170,37";"Udført";"Nej"
"06.08.2012";"FOCUS ØSTER FARIMA 77359";"-114,35";"-10.284,72";"Udført";"Nej"
"06.08.2012";"McDonald's         22705";"-207,50";"-10.492,22";"Udført";"Nej"
"06.08.2012";"DSB 7-Eleven Øster 55929";"-160,95";"-10.653,17";"Udført";"Nej"
"06.08.2012";"onfone.dk          35280";"-100,00";"-10.753,17";"Udført";"Nej"
"06.08.2012";"emmerys            73016";"-71,00";"-10.824,17";"Udført";"Nej"
"06.08.2012";"FOCUS ØSTER FARIMA 77712";"-89,85";"-10.914,02";"Udført";"Nej"
"06.08.2012";"Irma Oslo Plads    51495";"-371,50";"-11.285,52";"Udført";"Nej"
"06.08.2012";"Toscana Due        15568";"-134,00";"-11.419,52";"Udført";"Nej"
"07.08.2012";"Reinh. van Hauen   60117";"-82,12";"-11.501,64";"Udført";"Nej"
"07.08.2012";"FOCUS ØSTER FARIMA 78118";"-53,95";"-11.555,59";"Udført";"Nej"
"07.08.2012";"Irma Oslo Plads    15845";"-359,84";"-11.915,43";"Udført";"Nej"
"08.08.2012";"VAISENHUS APOTEK   48873";"-172,00";"-12.087,43";"Udført";"Nej"
"08.08.2012";"A. BUSCK, KBH      65912";"-359,90";"-12.447,33";"Udført";"Nej"
"08.08.2012";"Lemontblanc        00437";"-139,00";"-12.586,33";"Udført";"Nej"
"08.08.2012";"Faraos Cigarer     43949";"-1.195,00";"-13.781,33";"Udført";"Nej"
"08.08.2012";"Games/Karrusella   36868";"-729,00";"-14.510,33";"Udført";"Nej"
"08.08.2012";"Irma Oslo Plads    16710";"-288,50";"-14.798,83";"Udført";"Nej"
"09.08.2012";"VDK DKK    39,00";"-39,00";"-14.837,83";"Udført";"Nej"
"09.08.2012";"onfone.dk          00500";"-50,00";"-14.887,83";"Udført";"Nej"
"09.08.2012";"SuperB Borgergade  06762";"-593,52";"-15.481,35";"Udført";"Nej"
"10.08.2012";"KØBMANDSGÅRDEN     02344";"-573,85";"-16.055,20";"Udført";"Nej"
"13.08.2012";"LISELEJE BAGEREN A 48484";"-119,00";"-16.174,20";"Udført";"Nej"
"13.08.2012";"Imerco Frederiksvæ 95679";"-71,90";"-16.246,10";"Udført";"Nej"
"13.08.2012";"Bog og Ide         15111";"-399,95";"-16.646,05";"Udført";"Nej"
"13.08.2012";"Bog og Ide         15113";"-139,85";"-16.785,90";"Udført";"Nej"
"13.08.2012";"Lisestuens Isbar   03392";"-122,50";"-16.908,40";"Udført";"Nej"
"13.08.2012";"HØRSHOLM ISENKRAM  19310";"-5.610,00";"-22.518,40";"Udført";"Nej"
"13.08.2012";"IRMA HELSINGE      81038";"-389,00";"-22.907,40";"Udført";"Nej"
"13.08.2012";"7-Eleven B 417     06375";"-512,21";"-23.419,61";"Udført";"Nej"
"13.08.2012";"Shawarma ApS       08225";"-128,00";"-23.547,61";"Udført";"Nej"
"13.08.2012";"Mcdonalds Fr.bergg 88768";"-130,50";"-23.678,11";"Udført";"Nej"
"13.08.2012";"TIVOLI A/S         44285";"-294,00";"-23.972,11";"Udført";"Nej"
"13.08.2012";"Solsikken          10501";"-60,00";"-24.032,11";"Udført";"Nej"
"13.08.2012";"Solsikken          10507";"-60,00";"-24.092,11";"Udført";"Nej"
"13.08.2012";"Dankort PH 1000 0667831";"-91,95";"-24.184,06";"Udført";"Nej"
"13.08.2012";"MULBERRY           07693";"-100,00";"-24.284,06";"Udført";"Nej"
"13.08.2012";"Irma Nørre Voldg.  59525";"-419,72";"-24.703,78";"Udført";"Nej"
"14.08.2012";"VDK DKK   555,00";"-555,00";"-25.258,78";"Udført";"Nej"
"14.08.2012";"VDK DKK    39,00";"-39,00";"-25.297,78";"Udført";"Nej"
"14.08.2012";"Irma Oslo Plads    17418";"-546,00";"-25.843,78";"Udført";"Nej"
"15.08.2012";"Schantz Data A/S";"1.924,00";"-23.919,78";"Udført";"Nej"
"15.08.2012";"Dag H              23769";"-1.000,00";"-24.919,78";"Udført";"Nej"
"15.08.2012";"KAZA A/S           82555";"-135,00";"-25.054,78";"Udført";"Nej"
"15.08.2012";"Reinh. van Hauen   61875";"-42,95";"-25.097,73";"Udført";"Nej"
"15.08.2012";"PIZZAHUSET         36704";"-165,00";"-25.262,73";"Udført";"Nej"
"15.08.2012";"LABCPH             08937";"-599,00";"-25.861,73";"Udført";"Nej"
"15.08.2012";"FOCUS ØSTER FARIMA 82011";"-186,35";"-26.048,08";"Udført";"Nej"
"16.08.2012";"VDK DKK  1360,00";"-1.360,00";"-27.408,08";"Udført";"Nej"
"16.08.2012";"7-Eleven B 21      75754";"-76,00";"-27.484,08";"Udført";"Nej"
"16.08.2012";"Irma Codanhus 2301 61166";"-36,50";"-27.520,58";"Udført";"Nej"
"16.08.2012";"Corner Shop v/Vari 42951";"-70,00";"-27.590,58";"Udført";"Nej"
"16.08.2012";"Irma Oslo Plads    49992";"-261,00";"-27.851,58";"Udført";"Nej"
"16.08.2012";"TRIANGEL HÆLEBAR   23050";"-62,00";"-27.913,58";"Udført";"Nej"
"16.08.2012";"FOCUS ØSTER FARIMA 82474";"-85,90";"-27.999,48";"Udført";"Nej"
"17.08.2012";"Lemontblanc        01623";"-156,00";"-28.155,48";"Udført";"Nej"
"17.08.2012";"Candy Megastore Sw 98168";"-129,00";"-28.284,48";"Udført";"Nej"
"17.08.2012";"Q8 Service - 8060  25666";"-46,95";"-28.331,43";"Udført";"Nej"
"20.08.2012";"Q8 Service - 8060  38339";"-438,51";"-28.769,94";"Udført";"Nej"
"20.08.2012";"LISELEJE BAGEREN A 49040";"-97,00";"-28.866,94";"Udført";"Nej"
"20.08.2012";"Fakta 392          68589";"-52,90";"-28.919,84";"Udført";"Nej"
"20.08.2012";"STARK Frederiksvær 09693";"-541,65";"-29.461,49";"Udført";"Nej"
"20.08.2012";"FDB Kvickly Freder 22768";"-1.019,78";"-30.481,27";"Udført";"Nej"
"20.08.2012";"FDB Kvickly Freder 03878";"-82,00";"-30.563,27";"Udført";"Nej"
"20.08.2012";"LISELEJE BAGEREN A 57878";"-105,00";"-30.668,27";"Udført";"Nej"
"20.08.2012";"IRMA RYESGADE 60   99846";"-102,00";"-30.770,27";"Udført";"Nej"
"20.08.2012";"Netto Havnestaden  57479";"-386,00";"-31.156,27";"Udført";"Nej"
"20.08.2012";"Irma Oslo Plads    58312";"-500,50";"-31.656,77";"Udført";"Nej"
"20.08.2012";"Sidewalk           21415";"-600,00";"-32.256,77";"Udført";"Nej"
"20.08.2012";"FOCUS ØSTER FARIMA 84875";"-76,45";"-32.333,22";"Udført";"Nej"
"20.08.2012";"Service Kiosk v/Ni 06004";"-53,00";"-32.386,22";"Udført";"Nej"
"21.08.2012";"VDK DKK    39,00";"-39,00";"-32.425,22";"Udført";"Nej"
"21.08.2012";"Irma Oslo Plads    19205";"-422,00";"-32.847,22";"Udført";"Nej"
"22.08.2012";"Irma Oslo Plads    51026";"-390,00";"-33.237,22";"Udført";"Nej"
"23.08.2012";"Schantz Data A/S";"386,00";"-32.851,22";"Udført";"Nej"
"23.08.2012";"Cykelmageren       16814";"-190,00";"-33.041,22";"Udført";"Nej"
"23.08.2012";"McDonald's         01948";"-187,50";"-33.228,72";"Udført";"Nej"
"23.08.2012";"BAKKENS INFORMATIO 42619";"-50,00";"-33.278,72";"Udført";"Nej"
"24.08.2012";"7-Eleven B 15      95066";"-132,85";"-33.411,57";"Udført";"Nej"
"24.08.2012";"Irma Codanhus 2301 66627";"-52,00";"-33.463,57";"Udført";"Nej"
"24.08.2012";"Oakley brilleglas";"1.360,00";"-32.103,57";"Udført";"Nej"
"24.08.2012";"Shell Service-1189 19093";"-419,91";"-32.523,48";"Udført";"Nej"
"24.08.2012";"KØBMANDSGÅRDEN     11287";"-474,60";"-32.998,08";"Udført";"Nej"
"24.08.2012";"TDC Yousee         38813";"-39,70";"-33.037,78";"Udført";"Nej"
"27.08.2012";"VDK DKK   160,00";"-160,00";"-33.197,78";"Udført";"Nej"
"27.08.2012";"LISELEJE BAGEREN A 58714";"-146,00";"-33.343,78";"Udført";"Nej"
"27.08.2012";"LISELEJE BAGEREN A 58804";"-60,00";"-33.403,78";"Udført";"Nej"
"27.08.2012";"STARK Frederiksvær 10611";"-4.336,30";"-37.740,08";"Udført";"Nej"
"27.08.2012";"KØBMANDSGÅRDEN     25410";"-454,70";"-38.194,78";"Udført";"Nej"
"27.08.2012";"onfone.dk          57049";"-100,00";"-38.294,78";"Udført";"Nej"
"27.08.2012";"FOCUS ØSTER FARIMA 87804";"-13,45";"-38.308,23";"Udført";"Nej"
"27.08.2012";"IRMA RYESGADE 60   84687";"-92,50";"-38.400,73";"Udført";"Nej"
"27.08.2012";"Irma Oslo Plads    21507";"-459,00";"-38.859,73";"Udført";"Nej"
"28.08.2012";"VDK DKK    39,00";"-39,00";"-38.898,73";"Udført";"Nej"
"28.08.2012";"onfone.dk          00397";"-50,00";"-38.948,73";"Udført";"Nej"
"28.08.2012";"onfone.dk          04088";"-25,00";"-38.973,73";"Udført";"Nej"
"28.08.2012";"McDonald's Nørrevo 51419";"-252,50";"-39.226,23";"Udført";"Nej"
"29.08.2012";"Irma Oslo Plads    22597";"-376,50";"-39.602,73";"Udført";"Nej"
"30.08.2012";"VDK USD     9,99";"-60,37";"-39.663,10";"Udført";"Nej"
"30.08.2012";"VDK DKK    99,00";"-99,00";"-39.762,10";"Udført";"Nej"
"30.08.2012";"Vin og Tobak v/Mas 75038";"-205,00";"-39.967,10";"Udført";"Nej"
"30.08.2012";"Irma Oslo Plads    53236";"-294,00";"-40.261,10";"Udført";"Nej"
"31.08.2012";"budget";"-20.000,00";"-60.261,10";"Udført";"Nej"
"31.08.2012";"VDK DKK    99,00";"-99,00";"-60.360,10";"Udført";"Nej"
"31.08.2012";"VDK DKK   609,00";"-609,00";"-60.969,10";"Udført";"Nej"
"31.08.2012";"VDK DKK   148,00";"-148,00";"-61.117,10";"Udført";"Nej"
"31.08.2012";"Lønoverførsel";"31.537,14";"-29.579,96";"Udført";"Nej"
"31.08.2012";"TV 2/DANMARK       13374";"-19,00";"-29.598,96";"Udført";"Nej"
"31.08.2012";"Irma Codanhus 2301 01235";"-324,00";"-29.922,96";"Udført";"Nej"
"31.08.2012";"Irma Oslo Plads    23105";"-883,00";"-30.805,96";"Udført";"Nej"
"31.08.2012";"Gebyrer i alt";"-10,00";"-30.815,96";"Udført";"Nej"
"02.09.2012";"Ovf. til budget";"-16.000,00";"-46.815,96";"Udført";"Nej"
"02.09.2012";"Ovf. Sep. - Jette";"38.000,00";"-8.815,96";"Udført";"Nej"
"02.09.2012";"Lommepenge - Jon";"-3.000,00";"-11.815,96";"Udført";"Nej"
"02.09.2012";"Lommepenge - Jette";"-3.000,00";"-14.815,96";"Udført";"Nej"
"02.09.2012";"Lommepenge - Thilde";"-1.000,00";"-15.815,96";"Udført";"Nej"
"03.09.2012";"onfone.dk          32824";"-123,75";"-15.939,71";"Udført";"Nej"
"03.09.2012";"ZISAR HARIDREZZER  13889";"-210,00";"-16.149,71";"Udført";"Nej"
"03.09.2012";"A. BUSCK, KBH      99145";"-299,85";"-16.449,56";"Udført";"Nej"
"03.09.2012";"onfone.dk          17407";"-50,00";"-16.499,56";"Udført";"Nej"
"03.09.2012";"Bog & Idé Købmager 73758";"-144,75";"-16.644,31";"Udført";"Nej"
"03.09.2012";"Holms bager        56489";"-37,00";"-16.681,31";"Udført";"Nej"
"03.09.2012";"Statoil - 10308    27980";"-74,85";"-16.756,16";"Udført";"Nej"
"03.09.2012";"LISELEJE BAGEREN A 49728";"-157,50";"-16.913,66";"Udført";"Nej"
"03.09.2012";"STARK Frederiksvær 50768";"-7.483,33";"-24.396,99";"Udført";"Nej"
"03.09.2012";"STARK Frederiksvær 50770";"-642,65";"-25.039,64";"Udført";"Nej"
"03.09.2012";"SPAR LISELEJE ApS  21646";"-134,45";"-25.174,09";"Udført";"Nej"
"03.09.2012";"McDonald's Nørrevo 02527";"-256,00";"-25.430,09";"Udført";"Nej"
"03.09.2012";"Irma Oslo Plads    23730";"-982,00";"-26.412,09";"Udført";"Nej"
"03.09.2012";"Irma Oslo Plads    23732";"-32,50";"-26.444,59";"Udført";"Nej"
"04.09.2012";"VDK DKK    39,00";"-39,00";"-26.483,59";"Udført";"Nej"
"04.09.2012";"VDK DKK   977,54";"-977,54";"-27.461,13";"Udført";"Nej"
"04.09.2012";"ELGIGANTEN A/S     74638";"-838,00";"-28.299,13";"Udført";"Nej"
"04.09.2012";"onfone.dk          13752";"-50,00";"-28.349,13";"Udført";"Nej"
"04.09.2012";"Irma Oslo Plads    23384";"-347,34";"-28.696,47";"Udført";"Nej"
"05.09.2012";"VDK DKK     2,39";"2,39";"-28.694,08";"Udført";"Nej"
"05.09.2012";"Irma Oslo Plads    23752";"-350,00";"-29.044,08";"Udført";"Nej"
"06.09.2012";"10330270";"89,94";"-28.954,14";"Udført";"Nej"
"06.09.2012";"IRMA RYESGADE 60   02119";"-229,00";"-29.183,14";"Udført";"Nej"
"06.09.2012";"Irma Oslo Plads    24190";"-255,00";"-29.438,14";"Udført";"Nej"
"07.09.2012";"japps.dk";"-45,00";"-29.483,14";"Udført";"Nej"
"07.09.2012";"7-Eleven B 12      97673";"-238,00";"-29.721,14";"Udført";"Nej"
"07.09.2012";"Englebørn          32120";"-349,00";"-30.070,14";"Udført";"Nej"
"07.09.2012";"GRØNLYKKE.COM ApS  16871";"-198,00";"-30.268,14";"Udført";"Nej"
"07.09.2012";"Irma Oslo Plads    25226";"-591,00";"-30.859,14";"Udført";"Nej"
"07.09.2012";"Monsson Accessoriz 66838";"-89,00";"-30.948,14";"Udført";"Nej"
"10.09.2012";"VDK DKK    39,00";"-39,00";"-30.987,14";"Udført";"Nej"
"10.09.2012";"CARRE COPENHAGEN   18798";"-1.200,00";"-32.187,14";"Udført";"Nej"
"10.09.2012";"MATAS - 12527      01282";"-40,00";"-32.227,14";"Udført";"Nej"
"10.09.2012";"KGL. HOFJUVELER P. 13231";"-350,00";"-32.577,14";"Udført";"Nej"
"10.09.2012";"Vedels             02183";"-124,00";"-32.701,14";"Udført";"Nej"
"10.09.2012";"TIVOLI A/S         50719";"-588,00";"-33.289,14";"Udført";"Nej"
"10.09.2012";"Arkadens Isbod     73802";"-80,00";"-33.369,14";"Udført";"Nej"
"10.09.2012";"MCDONALD'S         34283";"-44,00";"-33.413,14";"Udført";"Nej"
"10.09.2012";"MCDONALD'S         65109";"-334,00";"-33.747,14";"Udført";"Nej"
"10.09.2012";"FOCUS ØSTER FARIMA 95022";"-28,95";"-33.776,09";"Udført";"Nej"
"10.09.2012";"IRMA RYESGADE 60   97671";"-686,50";"-34.462,59";"Udført";"Nej"
"10.09.2012";"FOCUS ØSTER FARIMA 95010";"-39,90";"-34.502,49";"Udført";"Nej"
"10.09.2012";"Lagkagehuset Frede 42544";"-429,00";"-34.931,49";"Udført";"Nej"
"10.09.2012";"Billig VVS ApS     24243";"-587,04";"-35.518,53";"Udført";"Nej"
"10.09.2012";"Paradis Trianglen  05190";"-200,00";"-35.718,53";"Udført";"Nej"
"10.09.2012";"Irma Oslo Plads    24955";"-415,00";"-36.133,53";"Udført";"Nej"
"11.09.2012";"VDK DKK    39,00";"-39,00";"-36.172,53";"Udført";"Nej"
"11.09.2012";"Reinh. van Hauen   50835";"-34,95";"-36.207,48";"Udført";"Nej"
"11.09.2012";"IRMA RYESGADE 60   99944";"-195,50";"-36.402,98";"Udført";"Nej"
"12.09.2012";"VDK DKK    12,00";"-12,00";"-36.414,98";"Udført";"Nej"
"12.09.2012";"Automatudb. 2104-1802";"-1.700,00";"-38.114,98";"Udført";"Nej"
"12.09.2012";"Q8 Service - 8020  31050";"-488,70";"-38.603,68";"Udført";"Nej"
"12.09.2012";"Irma Oslo Plads    55286";"-245,50";"-38.849,18";"Udført";"Nej"
"12.09.2012";"FOCUS ØSTER FARIMA 96856";"-53,00";"-38.902,18";"Udført";"Nej"
"12.09.2012";"PULCINELLA PIZZARI 43829";"-152,00";"-39.054,18";"Udført";"Nej"
"12.09.2012";"Mcdonalds Frederik 47673";"-88,50";"-39.142,68";"Udført";"Nej"
"13.09.2012";"Statoil - 10308    56962";"-119,85";"-39.262,53";"Udført";"Nej"
"13.09.2012";"BR-LEGETØJ - 2124  15353";"-139,85";"-39.402,38";"Udført";"Nej"
"13.09.2012";"Player ApS         68192";"-550,00";"-39.952,38";"Udført";"Nej"
"13.09.2012";"LABCPH             09547";"-350,00";"-40.302,38";"Udført";"Nej"
"13.09.2012";"Nespresso Danmark  39358";"-1.203,00";"-41.505,38";"Udført";"Nej"
"13.09.2012";"Irma 23021         76333";"-212,00";"-41.717,38";"Udført";"Nej"
"13.09.2012";"Irma Oslo Plads    40890";"-185,50";"-41.902,88";"Udført";"Nej"
"14.09.2012";"VDK DKK    39,00";"-39,00";"-41.941,88";"Udført";"Nej"
"14.09.2012";"Irma Codanhus 2301 83157";"-74,50";"-42.016,38";"Udført";"Nej"
"14.09.2012";"Vedels             03249";"-154,00";"-42.170,38";"Udført";"Nej"
"14.09.2012";"Halifax            06126";"-772,00";"-42.942,38";"Udført";"Nej"
"14.09.2012";"Blockbuster Video  18518";"-454,90";"-43.397,28";"Udført";"Nej"
"17.09.2012";"7-Eleven B 01      46100";"-104,80";"-43.502,08";"Udført";"Nej"
"17.09.2012";"FRISØR IVONETT     11518";"-470,00";"-43.972,08";"Udført";"Nej"
"17.09.2012";"Games/Karrusella   07317";"-179,00";"-44.151,08";"Udført";"Nej"
"17.09.2012";"A. BUSCK, KBH      11785";"-119,80";"-44.270,88";"Udført";"Nej"
"17.09.2012";"FONA AFD. FS/110   93555";"-309,85";"-44.580,73";"Udført";"Nej"
"17.09.2012";"Lemontblanc        04752";"-127,00";"-44.707,73";"Udført";"Nej"
"17.09.2012";"Irma Illum         80824";"-246,50";"-44.954,23";"Udført";"Nej"
"17.09.2012";"Morten Holm        21978";"-97,00";"-45.051,23";"Udført";"Nej"
"17.09.2012";"Shell Service-1520 10766";"-460,14";"-45.511,37";"Udført";"Nej"
"17.09.2012";"JOE & THE JUICE    90215";"-710,00";"-46.221,37";"Udført";"Nej"
"17.09.2012";"Baresso Coffee A/S 15248";"-102,00";"-46.323,37";"Udført";"Nej"
"17.09.2012";"Baresso Coffee A/S 15250";"-48,00";"-46.371,37";"Udført";"Nej"
"17.09.2012";"Irma Østerbrog.52  77738";"-226,50";"-46.597,87";"Udført";"Nej"
"17.09.2012";"PIZZAHUSET         51782";"-54,00";"-46.651,87";"Udført";"Nej"
"17.09.2012";"7-Eleven B 21      61183";"-81,90";"-46.733,77";"Udført";"Nej"
"17.09.2012";"Irma Oslo Plads    26894";"-292,50";"-47.026,27";"Udført";"Nej"
"17.09.2012";"FOCUS ØSTER FARIMA 99646";"-16,95";"-47.043,22";"Udført";"Nej"
"18.09.2012";"Irma Oslo Plads    28678";"-280,00";"-47.323,22";"Udført";"Nej"
"18.09.2012";"Paradis Trianglen  05682";"-100,00";"-47.423,22";"Udført";"Nej"
"19.09.2012";"Irma Oslo Plads    43663";"-380,00";"-47.803,22";"Udført";"Nej"
"20.09.2012";"Mathilde Ring";"-800,00";"-48.603,22";"Udført";"Nej"
"20.09.2012";"VDK EUR   173,80";"-1.308,78";"-49.912,00";"Udført";"Nej"
"20.09.2012";"Fædretur rest";"-373,00";"-50.285,00";"Udført";"Nej"
"20.09.2012";"FONA AFD. FS/110   09348";"-139,90";"-50.424,90";"Udført";"Nej"
"20.09.2012";"FONA AFD. FS/110   09356";"-69,95";"-50.494,85";"Udført";"Nej"
"20.09.2012";"H & M              57808";"-508,45";"-51.003,30";"Udført";"Nej"
"20.09.2012";"Holms bager        62012";"-37,00";"-51.040,30";"Udført";"Nej"
"20.09.2012";"The Bagel co.      32254";"-104,00";"-51.144,30";"Udført";"Nej"
"20.09.2012";"PULCINELLA PIZZARI 44067";"-102,00";"-51.246,30";"Udført";"Nej"
"21.09.2012";"Irma Oslo Plads    30375";"-408,00";"-51.654,30";"Udført";"Nej"
"21.09.2012";"DSB NETBUTIK       10774";"-329,00";"-51.983,30";"Udført";"Nej"
"21.09.2012";"DSB NETBUTIK       11952";"-309,00";"-52.292,30";"Udført";"Nej"
"24.09.2012";"Vedels             04691";"-126,00";"-52.418,30";"Udført";"Nej"
"24.09.2012";"Lemontblanc        05515";"-155,00";"-52.573,30";"Udført";"Nej"
"24.09.2012";"Fona FF12          45951";"-179,95";"-52.753,25";"Udført";"Nej"
"24.09.2012";"The North Face Sto 06751";"-1.568,00";"-54.321,25";"Udført";"Nej"
"24.09.2012";"Irma Oslo Plads    76595";"-665,50";"-54.986,75";"Udført";"Nej"
"24.09.2012";"Field's Parkering  52519";"-6,00";"-54.992,75";"Udført";"Nej"
"24.09.2012";"FOCUS ØSTER FARIMA 02804";"-162,95";"-55.155,70";"Udført";"Nej"
"24.09.2012";"FOCUS ØSTER FARIMA 02870";"-57,80";"-55.213,50";"Udført";"Nej"
"24.09.2012";"Statoil - 10848    32968";"-47,00";"-55.260,50";"Udført";"Nej"
"24.09.2012";"Statoil - 10848    32859";"-294,41";"-55.554,91";"Udført";"Nej"
"24.09.2012";"Spejder Sport A/S  14595";"-599,00";"-56.153,91";"Udført";"Nej"
"24.09.2012";"Irma Oslo Plads    30881";"-274,50";"-56.428,41";"Udført";"Nej"
"25.09.2012";"VDK DKK    39,00";"-39,00";"-56.467,41";"Udført";"Nej"
"25.09.2012";"Paradis Trianglen  05884";"-100,00";"-56.567,41";"Udført";"Nej"
"25.09.2012";"FOCUS ØSTER FARIMA 03757";"-72,95";"-56.640,36";"Udført";"Nej"
"25.09.2012";"PULCINELLA PIZZARI 44217";"-206,00";"-56.846,36";"Udført";"Nej"
"26.09.2012";"Irma Oslo Plads    28876";"-386,50";"-57.232,86";"Udført";"Nej"
"27.09.2012";"IRMA RYESGADE 60   15535";"-300,00";"-57.532,86";"Udført";"Nej"
"28.09.2012";"budget";"-20.000,00";"-77.532,86";"Udført";"Nej"
"28.09.2012";"Lønoverførsel";"31.537,14";"-45.995,72";"Udført";"Nej"
"28.09.2012";"onfone.dk          71718";"-50,00";"-46.045,72";"Udført";"Nej"
"28.09.2012";"onfone.dk          72339";"-25,00";"-46.070,72";"Udført";"Nej"
"28.09.2012";"MATAS - 14427      93774";"-63,00";"-46.133,72";"Udført";"Nej"
"28.09.2012";"Candy Megastore Sw 79986";"-117,00";"-46.250,72";"Udført";"Nej"
"28.09.2012";"Lemontblanc        06235";"-176,00";"-46.426,72";"Udført";"Nej"
"28.09.2012";"The Bagel co.      32938";"-48,00";"-46.474,72";"Udført";"Nej"
"28.09.2012";"Rente";"0,23";"-46.474,49";"Udført";"Nej"
"28.09.2012";"Rente";"-709,68";"-47.184,17";"Udført";"Nej"
"28.09.2012";"Danske Ekstra-pakke";"-75,00";"-47.259,17";"Udført";"Nej"
"01.10.2012";"Automatudb. 6737-4157";"-500,00";"-47.759,17";"Udført";"Nej"
"01.10.2012";"Netto Landemærket  46578";"-133,90";"-47.893,07";"Udført";"Nej"
"01.10.2012";"Magasin, Kgs Nytor 77423";"-477,00";"-48.370,07";"Udført";"Nej"
"01.10.2012";"MULBERRY           10890";"-100,00";"-48.470,07";"Udført";"Nej"
"01.10.2012";"Holms bager        64660";"-97,00";"-48.567,07";"Udført";"Nej"
"01.10.2012";"Magasin, Kgs Nytor 41655";"-225,00";"-48.792,07";"Udført";"Nej"
"01.10.2012";"Vedels             05826";"-132,00";"-48.924,07";"Udført";"Nej"
"01.10.2012";"ZISAR HARIDREZZER  14353";"-1.005,00";"-49.929,07";"Udført";"Nej"
"01.10.2012";"FOCUS ØSTER FARIMA 05801";"-132,35";"-50.061,42";"Udført";"Nej"
"01.10.2012";"Forum København Ap 38045";"-120,00";"-50.181,42";"Udført";"Nej"
"01.10.2012";"Second Female      15860";"-200,00";"-50.381,42";"Udført";"Nej"
"01.10.2012";"Forum København Ap 00532";"-32,00";"-50.413,42";"Udført";"Nej"
"01.10.2012";"TV 2/DANMARK       47170";"-19,00";"-50.432,42";"Udført";"Nej"
"01.10.2012";"Millian v/Gitte By 02541";"-1.099,00";"-51.531,42";"Udført";"Nej"
"01.10.2012";"FOCUS ØSTER FARIMA 06225";"-32,85";"-51.564,27";"Udført";"Nej"
"01.10.2012";"emmerys            89661";"-89,00";"-51.653,27";"Udført";"Nej"
"01.10.2012";"McDonald's         87450";"-199,00";"-51.852,27";"Udført";"Nej"
"01.10.2012";"Dækket overtræk";"-17.680,00";"-69.532,27";"Udført";"Nej"
"01.10.2012";"onfone.dk          77925";"-123,75";"-69.656,02";"Udført";"Nej"
"01.10.2012";"Ovf. Jette";"38.000,00";"-31.656,02";"Udført";"Nej"
"01.10.2012";"Skolebillede";"-420,00";"-32.076,02";"Udført";"Nej"
"01.10.2012";"Ovf. til budget";"-10.000,00";"-42.076,02";"Udført";"Nej"
"01.10.2012";"RD - Skovbovej";"-1.313,97";"-43.389,99";"Udført";"Nej"
"01.10.2012";"Irma Oslo Plads    81294";"-523,18";"-43.913,17";"Udført";"Nej"
"02.10.2012";"VDK USD     9,99";"-58,55";"-43.971,72";"Udført";"Nej"
"02.10.2012";"VDK DKK    99,00";"-99,00";"-44.070,72";"Udført";"Nej"
"02.10.2012";"VDK DKK    99,00";"-99,00";"-44.169,72";"Udført";"Nej"
"02.10.2012";"VDK DKK    39,00";"-39,00";"-44.208,72";"Udført";"Nej"
"02.10.2012";"Vedels             06426";"-56,00";"-44.264,72";"Udført";"Nej"
"02.10.2012";"Irma Oslo Plads    34306";"-364,50";"-44.629,22";"Udført";"Nej"
"03.10.2012";"TDC Yousee         95459";"-39,70";"-44.668,92";"Udført";"Nej"
"03.10.2012";"Irma Oslo Plads    82689";"-322,66";"-44.991,58";"Udført";"Nej"
"04.10.2012";"Fjernvarme - Malmøg.";"-1.653,67";"-46.645,25";"Udført";"Nej"
"04.10.2012";"VDK DKK    39,00";"-39,00";"-46.684,25";"Udført";"Nej"
"04.10.2012";"KBL";"-300,00";"-46.984,25";"Udført";"Nej"
"04.10.2012";"Corner Shop v/Vari 53471";"-60,00";"-47.044,25";"Udført";"Nej"
"04.10.2012";"Husleje - SPG";"17.700,00";"-29.344,25";"Udført";"Nej"
"04.10.2012";"Irma Oslo Plads    50924";"-492,00";"-29.836,25";"Udført";"Nej"
"04.10.2012";"Lommep. Mathilde";"-1.000,00";"-30.836,25";"Udført";"Nej"
"05.10.2012";"Irma Nørre Voldg.  07281";"-112,00";"-30.948,25";"Udført";"Nej"
"05.10.2012";"PULCINELLA PIZZARI 44574";"-154,00";"-31.102,25";"Udført";"Nej"
"07.10.2012";"Lp okt";"-3.000,00";"-34.102,25";"Udført";"Nej"
"08.10.2012";"Holms bager        60977";"-97,00";"-34.199,25";"Udført";"Nej"
"08.10.2012";"Player ApS         70467";"-500,00";"-34.699,25";"Udført";"Nej"
"08.10.2012";"Morten Holm        28240";"-98,00";"-34.797,25";"Udført";"Nej"
"08.10.2012";"McDonald's         30855";"-217,00";"-35.014,25";"Udført";"Nej"
"08.10.2012";"7-Eleven B 15      50149";"-13,95";"-35.028,20";"Udført";"Nej"
"08.10.2012";"Baresso Coffee A/S 82603";"-189,00";"-35.217,20";"Udført";"Nej"
"08.10.2012";"Irma Oslo Plads    52103";"-772,00";"-35.989,20";"Udført";"Nej"
"08.10.2012";"FOCUS ØSTER FARIMA 09958";"-66,95";"-36.056,15";"Udført";"Nej"
"08.10.2012";"Irma Oslo Plads    85174";"-137,50";"-36.193,65";"Udført";"Nej"
"09.10.2012";"VDK DKK   999,00";"-999,00";"-37.192,65";"Udført";"Nej"
"09.10.2012";"Automatudb. 2104-3544";"-1.500,00";"-38.692,65";"Udført";"Nej"
"09.10.2012";"Implantatklinik Kø 05612";"-2.114,53";"-40.807,18";"Udført";"Nej"
"09.10.2012";"Humac - APP        09958";"-299,00";"-41.106,18";"Udført";"Nej"
"09.10.2012";"Irma Oslo Plads    85817";"-231,50";"-41.337,68";"Udført";"Nej"
"09.10.2012";"Irma Codanhus 2301 01079";"-144,00";"-41.481,68";"Udført";"Nej"
"10.10.2012";"www.larvefødder.dk 05020";"-1.194,20";"-42.675,88";"Udført";"Nej"
"10.10.2012";"Irma Oslo Plads    86864";"-401,00";"-43.076,88";"Udført";"Nej"
"11.10.2012";"Vedels             08092";"-88,00";"-43.164,88";"Udført";"Nej"
"11.10.2012";"Irma Oslo Plads    60580";"-394,95";"-43.559,83";"Udført";"Nej"
"12.10.2012";"Schantz Data A/S";"299,00";"-43.260,83";"Udført";"Nej"
"12.10.2012";"McDonald's         82847";"-183,50";"-43.444,33";"Udført";"Nej"
"12.10.2012";"Spejder Sport A/S  15026";"-2.298,00";"-45.742,33";"Udført";"Nej"
"12.10.2012";"Candy Megastore Sw 14108";"-80,50";"-45.822,83";"Udført";"Nej"
"15.10.2012";"7-Eleven B 01      08611";"-24,95";"-45.847,78";"Udført";"Nej"
"15.10.2012";"DSB 7-Eleven Øster 94057";"-180,00";"-46.027,78";"Udført";"Nej"
"15.10.2012";"Irma Oslo Plads    88190";"-697,50";"-46.725,28";"Udført";"Nej"
"15.10.2012";"ESTATE COFFEE      71883";"-132,00";"-46.857,28";"Udført";"Nej"
"15.10.2012";"Cph. Skatepark     03109";"-380,00";"-47.237,28";"Udført";"Nej"
"15.10.2012";"Q8 Service - 8007  18797";"-502,42";"-47.739,70";"Udført";"Nej"
"15.10.2012";"onfone.dk          73632";"-50,00";"-47.789,70";"Udført";"Nej"
"15.10.2012";"emmerys            93806";"-80,00";"-47.869,70";"Udført";"Nej"
"15.10.2012";"Vedels             08630";"-64,50";"-47.934,20";"Udført";"Nej"
"15.10.2012";"FOCUS ØSTER FARIMA 13657";"-74,95";"-48.009,15";"Udført";"Nej"
"15.10.2012";"PULCINELLA PIZZARI 44866";"-52,00";"-48.061,15";"Udført";"Nej"
"15.10.2012";"Lommepenge - jette";"-3.000,00";"-51.061,15";"Udført";"Nej"
"15.10.2012";"CALIFORNIA SPORTS  01175";"-500,00";"-51.561,15";"Udført";"Nej"
"15.10.2012";"Københavns Energi";"1.653,67";"-49.907,48";"Udført";"Nej"
"15.10.2012";"Ikea - 121, ACO    64459";"-387,00";"-50.294,48";"Udført";"Nej"
"15.10.2012";"Irma Oslo Plads    89445";"-551,38";"-50.845,86";"Udført";"Nej"
"15.10.2012";"Ikea - 121, ECO    13848";"-3.259,00";"-54.104,86";"Udført";"Nej"
"16.10.2012";"Realkredit Danmark";"1.313,97";"-52.790,89";"Udført";"Nej"
"16.10.2012";"VDK DKK     6,00";"-6,00";"-52.796,89";"Udført";"Nej"
"16.10.2012";"Elgiganten 3031    03192";"-668,00";"-53.464,89";"Udført";"Nej"
"16.10.2012";"Irma Oslo Plads    38581";"-310,00";"-53.774,89";"Udført";"Nej"
"17.10.2012";"VDK DKK    39,00";"-39,00";"-53.813,89";"Udført";"Nej"
"17.10.2012";"Lemontblanc        08464";"-125,00";"-53.938,89";"Udført";"Nej"
"17.10.2012";"Nordisk Film Bio   99848";"-196,65";"-54.135,54";"Udført";"Nej"
"17.10.2012";"FOCUS ØSTER FARIMA 14593";"-43,95";"-54.179,49";"Udført";"Nej"
"17.10.2012";"PALADS TEATRET     41093";"-54,45";"-54.233,94";"Udført";"Nej"
"17.10.2012";"DUXIANA            06139";"-17.260,00";"-71.493,94";"Udført";"Nej"
"17.10.2012";"Irma Oslo Plads    57224";"-297,50";"-71.791,44";"Udført";"Nej"
"18.10.2012";"Brdr.Sørensens Eft 36124";"-86,00";"-71.877,44";"Udført";"Nej"
"18.10.2012";"Irma Nørre Voldg.  19409";"-86,50";"-71.963,94";"Udført";"Nej"
"18.10.2012";"McDonald's Nørrevo 97679";"-240,00";"-72.203,94";"Udført";"Nej"
"19.10.2012";"I Form";"-119,90";"-72.323,84";"Udført";"Nej"
"19.10.2012";"Vedels             09223";"-105,00";"-72.428,84";"Udført";"Nej"
"19.10.2012";"FOCUS ØSTER FARIMA 15223";"-66,90";"-72.495,74";"Udført";"Nej"
"19.10.2012";"REINH. VAN HAUEN   19104";"-61,36";"-72.557,10";"Udført";"Nej"
"19.10.2012";"VAISENHUS APOTEK   12596";"-66,00";"-72.623,10";"Udført";"Nej"
"19.10.2012";"A. BUSCK, KBH      09084";"-29,95";"-72.653,05";"Udført";"Nej"
"19.10.2012";"H & M              75148";"-159,90";"-72.812,95";"Udført";"Nej"
"19.10.2012";"Stelling A7S       00317";"-27,00";"-72.839,95";"Udført";"Nej"
"19.10.2012";"Creas A/S          31164";"-90,00";"-72.929,95";"Udført";"Nej"
"19.10.2012";"BYMAN CYKLERS EFTF 69954";"-165,00";"-73.094,95";"Udført";"Nej"
"19.10.2012";"Vedels             09279";"-84,00";"-73.178,95";"Udført";"Nej"
"19.10.2012";"E BILLET A/S       64504";"-166,62";"-73.345,57";"Udført";"Nej"
"19.10.2012";"GRAND TEATRET A/S  13197";"-58,00";"-73.403,57";"Udført";"Nej"
"19.10.2012";"Flying Chef 1 ApS  00451";"-75,00";"-73.478,57";"Udført";"Nej"
"19.10.2012";"Irma Nørre Voldg.  20433";"-130,00";"-73.608,57";"Udført";"Nej"
"22.10.2012";"STARK Frederiksvær 54254";"-734,75";"-74.343,32";"Udført";"Nej"
"22.10.2012";"KØBMANDSHJØRNET    87867";"-66,10";"-74.409,42";"Udført";"Nej"
"22.10.2012";"TisvildelejeBagere 35266";"-74,50";"-74.483,92";"Udført";"Nej"
"22.10.2012";"Pink               04677";"-799,00";"-75.282,92";"Udført";"Nej"
"22.10.2012";"KØBMANDSGÅRDEN     40186";"-494,40";"-75.777,32";"Udført";"Nej"
"22.10.2012";"LISELEJE BAGEREN A 12313";"-85,00";"-75.862,32";"Udført";"Nej"
"22.10.2012";"LISELEJE BAGEREN A 63486";"-16,50";"-75.878,82";"Udført";"Nej"
"22.10.2012";"PULCINELLA PIZZARI 45049";"-204,00";"-76.082,82";"Udført";"Nej"
"22.10.2012";"FOCUS ØSTER FARIMA 16546";"-67,95";"-76.150,77";"Udført";"Nej"
"22.10.2012";"7-Eleven B 417     26594";"-471,16";"-76.621,93";"Udført";"Nej"
"22.10.2012";"Irma Nørre Voldg.  32845";"-399,50";"-77.021,43";"Udført";"Nej"
"23.10.2012";"7-Eleven B 01      11188";"-38,50";"-77.059,93";"Udført";"Nej"
"23.10.2012";"Vedels             09773";"-83,50";"-77.143,43";"Udført";"Nej"
"23.10.2012";"Baresso Coffee A/S 23730";"-40,00";"-77.183,43";"Udført";"Nej"
"23.10.2012";"FUURSTED PAPIR     29506";"-65,00";"-77.248,43";"Udført";"Nej"
"23.10.2012";"Baresso Coffee A/S 84063";"-43,00";"-77.291,43";"Udført";"Nej"
"23.10.2012";"Irma Codanhus 2301 09828";"-302,00";"-77.593,43";"Udført";"Nej"
"24.10.2012";"Reinh. van Hauen   60921";"-55,90";"-77.649,33";"Udført";"Nej"
"24.10.2012";"Irma Oslo Plads    34546";"-347,28";"-77.996,61";"Udført";"Nej"
"25.10.2012";"Irma Østerbrog.52  12049";"-70,00";"-78.066,61";"Udført";"Nej"
"25.10.2012";"Reinh. van Hauen   61162";"-90,50";"-78.157,11";"Udført";"Nej"
"25.10.2012";"Tiger 37           22795";"-60,00";"-78.217,11";"Udført";"Nej"
"25.10.2012";"FOCUS ØSTER FARIMA 18160";"-84,95";"-78.302,06";"Udført";"Nej"
"25.10.2012";"Irma Nørre Voldg.  26064";"-327,00";"-78.629,06";"Udført";"Nej"
"02.01.2012";"Vedels             66159";"-128,00";"-2.230,24";"Udført";"Nej"
"02.01.2012";"FOCUS ØSTER FARIMA 72444";"-23,95";"-2.254,19";"Udført";"Nej"
"02.01.2012";"FONA AFD. FS/110   19142";"-129,90";"-2.384,09";"Udført";"Nej"
"02.01.2012";"Morten Holm        03324";"-110,00";"-2.494,09";"Udført";"Nej"
"02.01.2012";"Irma Oslo Plads    51469";"-466,50";"-2.960,59";"Udført";"Nej"
"02.01.2012";"TOYS \"R\" US - 3109 56994";"-909,70";"-3.870,29";"Udført";"Nej"
"02.01.2012";"FOCUS ØSTER FARIMA 72725";"-51,90";"-3.922,19";"Udført";"Nej"
"02.01.2012";"onfone.dk          87551";"-99,00";"-4.021,19";"Udført";"Nej"
"02.01.2012";"FOCUS ØSTER FARIMA 73415";"-128,60";"-4.149,79";"Udført";"Nej"
"02.01.2012";"Magasin";"-300,00";"-4.449,79";"Udført";"Nej"
"02.01.2012";"Lederen";"-2.887,00";"-7.336,79";"Udført";"Nej"
"02.01.2012";"Irma Oslo Plads    49497";"-421,50";"-7.758,29";"Udført";"Nej"
"02.01.2012";"Ikea - 121, ACO    90530";"-1.368,00";"-9.126,29";"Udført";"Nej"
"02.01.2012";"The Bagel co.      06566";"-147,00";"-9.273,29";"Udført";"Nej"
"02.01.2012";"McDonald's Nørrevo 01067";"-197,50";"-9.470,79";"Udført";"Nej"
"03.01.2012";"VDK DKK   125,00";"-125,00";"-9.595,79";"Udført";"Nej"
"03.01.2012";"FOCUS ØSTER FARIMA 74090";"-73,35";"-9.669,14";"Udført";"Nej"
"03.01.2012";"APOTEKET TRIANGLEN 02994";"-80,90";"-9.750,04";"Udført";"Nej"
"03.01.2012";"FOCUS ØSTER FARIMA 74290";"-18,95";"-9.768,99";"Udført";"Nej"
"04.01.2012";"Statoil - 10742    47335";"-22,95";"-9.791,94";"Udført";"Nej"
"04.01.2012";"VDK DKK    48,00";"-48,00";"-9.839,94";"Udført";"Nej"
"04.01.2012";"VDK DKK    65,00";"-65,00";"-9.904,94";"Udført";"Nej"
"04.01.2012";"PETER BEIER CHOKOL 39028";"-88,48";"-9.993,42";"Udført";"Nej"
"04.01.2012";"Lån tilbage - Dec";"17.000,00";"7.006,58";"Udført";"Nej"
"04.01.2012";"Irma Oslo Plads    52747";"-548,00";"6.458,58";"Udført";"Nej"
"05.01.2012";"Implantatklinik Kø 05569";"-1.995,45";"4.463,13";"Udført";"Nej"
"05.01.2012";"FOCUS ØSTER FARIMA 74909";"-29,90";"4.433,23";"Udført";"Nej"
"05.01.2012";"PIZZAHUSET         37849";"-111,00";"4.322,23";"Udført";"Nej"
"06.01.2012";"onfone.dk          75045";"-50,00";"4.272,23";"Udført";"Nej"
"06.01.2012";"VDK DKK    24,00";"-24,00";"4.248,23";"Udført";"Nej"
"06.01.2012";"7-Eleven B 21      37160";"-32,95";"4.215,28";"Udført";"Nej"
"06.01.2012";"Tiger 37           62268";"-92,00";"4.123,28";"Udført";"Nej"
"06.01.2012";"RD - omprioritering";"6.700,00";"10.823,28";"Udført";"Nej"
"06.01.2012";"Irma Nørre Voldg.  83979";"-323,50";"10.499,78";"Udført";"Nej"
"06.01.2012";"FOCUS ØSTER FARIMA 75515";"-102,90";"10.396,88";"Udført";"Nej"
"09.01.2012";"SAXO.COM           78533";"-178,45";"10.218,43";"Udført";"Nej"
"09.01.2012";"Nordisk Film Bio   11411";"-211,66";"10.006,77";"Udført";"Nej"
"09.01.2012";"Irma Hellerup      80342";"-452,45";"9.554,32";"Udført";"Nej"
"09.01.2012";"SPORTMASTER A/S    35482";"-1.450,00";"8.104,32";"Udført";"Nej"
"09.01.2012";"NY CARLSBERG GLYPT 63536";"-75,00";"8.029,32";"Udført";"Nej"
"09.01.2012";"Imperial           17979";"-128,17";"7.901,15";"Udført";"Nej"
"09.01.2012";"SPORTMASTER        64927";"-399,90";"7.501,25";"Udført";"Nej"
"09.01.2012";"Uno-X Aut. Vasbyga 11529";"-554,32";"6.946,93";"Udført";"Nej"
"09.01.2012";"SuperB Nørrevold   21909";"-132,40";"6.814,53";"Udført";"Nej"
"09.01.2012";"FOCUS ØSTER FARIMA 76489";"-141,55";"6.672,98";"Udført";"Nej"
"09.01.2012";"SuperB Nørrevold   71897";"-62,50";"6.610,48";"Udført";"Nej"
"09.01.2012";"Ekstra til bugdet";"-3.500,00";"3.110,48";"Udført";"Nej"
"09.01.2012";"SuperB Ndr. Frihav 07684";"-247,60";"2.862,88";"Udført";"Nej"
"09.01.2012";"Irma Codanhus 2301 71630";"-101,00";"2.761,88";"Udført";"Nej"
"10.01.2012";"VDK DKK   149,98";"-149,98";"2.611,90";"Udført";"Nej"
"10.01.2012";"VDK DKK    39,00";"-39,00";"2.572,90";"Udført";"Nej"
"10.01.2012";"FONA AFD. FS/110   06935";"-499,95";"2.072,95";"Udført";"Nej"
"10.01.2012";"Irma 23021         79312";"-507,50";"1.565,45";"Udført";"Nej"
"11.01.2012";"Statoil - 10742    37710";"-22,95";"1.542,50";"Udført";"Nej"
"11.01.2012";"Spejder Sport A/S  04133";"-398,00";"1.144,50";"Udført";"Nej"
"11.01.2012";"Irma Oslo Plads    12997";"-459,50";"685,00";"Udført";"Nej"
"12.01.2012";"Irma Oslo Plads    56327";"-265,50";"419,50";"Udført";"Nej"
"12.01.2012";"DSB NETBUTIK       22483";"-398,00";"21,50";"Udført";"Nej"
"13.01.2012";"VDK DKK    39,00";"-39,00";"-17,50";"Udført";"Nej"
"13.01.2012";"Summerbirg Chocola 42110";"-420,00";"-437,50";"Udført";"Nej"
"13.01.2012";"SPORTMASTER VIMMEL 81686";"-199,95";"-637,45";"Udført";"Nej"
"13.01.2012";"Borger Kiosken     75662";"-70,00";"-707,45";"Udført";"Nej"
"13.01.2012";"Holms bager        02111";"-87,00";"-794,45";"Udført";"Nej"
"16.01.2012";"VDK DKK     6,00";"-6,00";"-800,45";"Udført";"Nej"
"16.01.2012";"THORVALDSENS MUSEU 03904";"-40,00";"-840,45";"Udført";"Nej"
"16.01.2012";"The living room    71301";"-116,00";"-956,45";"Udført";"Nej"
"16.01.2012";"FONA AFD. FS/110   15907";"-249,95";"-1.206,40";"Udført";"Nej"
"16.01.2012";"Morten Holm        64885";"-37,00";"-1.243,40";"Udført";"Nej"
"16.01.2012";"Blockbuster Video  72777";"-308,58";"-1.551,98";"Udført";"Nej"
"16.01.2012";"Vedels             68140";"-77,00";"-1.628,98";"Udført";"Nej"
"16.01.2012";"FOCUS ØSTER FARIMA 79645";"-92,75";"-1.721,73";"Udført";"Nej"
"16.01.2012";"Mejeriforeningen   73502";"-309,00";"-2.030,73";"Udført";"Nej"
"16.01.2012";"FOCUS ØSTER FARIMA 79830";"-137,70";"-2.168,43";"Udført";"Nej"
"16.01.2012";"Mejeriforeningen   14724";"-309,00";"-2.477,43";"Udført";"Nej"
"16.01.2012";"www.roomservice.dk 85119";"-514,00";"-2.991,43";"Udført";"Nej"
"16.01.2012";"Irma Oslo Plads    15197";"-747,50";"-3.738,93";"Udført";"Nej"
"16.01.2012";"Tiger 37           55021";"-10,00";"-3.748,93";"Udført";"Nej"
"16.01.2012";"Irma Fr.Borggade   58690";"-98,00";"-3.846,93";"Udført";"Nej"
"17.01.2012";"VDK DKK    42,00";"-42,00";"-3.888,93";"Udført";"Nej"
"17.01.2012";"ERHVERVSSKOLERNES  52575";"-599,00";"-4.487,93";"Udført";"Nej"
"17.01.2012";"McDonald's Nørrevo 05726";"-295,00";"-4.782,93";"Udført";"Nej"
"17.01.2012";"Irma Nørre Voldg.  92313";"-80,00";"-4.862,93";"Udført";"Nej"
"18.01.2012";"Statoil - 10742    76030";"-17,95";"-4.880,88";"Udført";"Nej"
"18.01.2012";"Vedels             68576";"-58,00";"-4.938,88";"Udført";"Nej"
"18.01.2012";"Lemontblanc        78997";"-52,00";"-4.990,88";"Udført";"Nej"
"18.01.2012";"PHOTOGRAFICA       64924";"-2.085,00";"-7.075,88";"Udført";"Nej"
"18.01.2012";"FOCUS ØSTER FARIMA 81019";"-57,35";"-7.133,23";"Udført";"Nej"
"18.01.2012";"Irma Oslo Plads    53880";"-249,00";"-7.382,23";"Udført";"Nej"
"19.01.2012";"SPG 56 - Varme";"-181,14";"-7.563,37";"Udført";"Nej"
"19.01.2012";"Irma City 23097    48787";"-289,00";"-7.852,37";"Udført";"Nej"
"20.01.2012";"SPORTMASTER A/S    37501";"1.349,95";"-6.502,42";"Udført";"Nej"
"20.01.2012";"Kruses Gastronomi  11657";"-26,00";"-6.528,42";"Udført";"Nej"
"20.01.2012";"VOIGT              57805";"-450,00";"-6.978,42";"Udført";"Nej"
"20.01.2012";"Irma Oslo Plads    17929";"-428,00";"-7.406,42";"Udført";"Nej"
"23.01.2012";"Irma Nørre Voldg.  69846";"-348,50";"-7.754,92";"Udført";"Nej"
"23.01.2012";"FONA AFD. FS/110   16307";"-199,95";"-7.954,87";"Udført";"Nej"
"23.01.2012";"Blockbuster Video  22046";"-39,00";"-7.993,87";"Udført";"Nej"
"23.01.2012";"DSB 7-Eleven Strue 23882";"-97,50";"-8.091,37";"Udført";"Nej"
"23.01.2012";"Vedels             69263";"-60,00";"-8.151,37";"Udført";"Nej"
"23.01.2012";"Kruses Gastronomi  11953";"-54,00";"-8.205,37";"Udført";"Nej"
"23.01.2012";"DSB 7-Eleven Kvikk 35384";"-70,40";"-8.275,77";"Udført";"Nej"
"23.01.2012";"FOCUS ØSTER FARIMA 83076";"-118,40";"-8.394,17";"Udført";"Nej"
"23.01.2012";"Vin og Tobak v/Mas 43323";"-350,00";"-8.744,17";"Udført";"Nej"
"23.01.2012";"emmerys            17823";"-62,50";"-8.806,67";"Udført";"Nej"
"23.01.2012";"emmerys            17825";"-9,00";"-8.815,67";"Udført";"Nej"
"23.01.2012";"Irma Codanhus 2301 79509";"-525,00";"-9.340,67";"Udført";"Nej"
"24.01.2012";"VDK USD    13,79";"-80,75";"-9.421,42";"Udført";"Nej"
"24.01.2012";"VDK DKK    12,00";"-12,00";"-9.433,42";"Udført";"Nej"
"24.01.2012";"VDK DKK    77,07";"-77,07";"-9.510,49";"Udført";"Nej"
"24.01.2012";"VDK DKK    24,00";"-24,00";"-9.534,49";"Udført";"Nej"
"24.01.2012";"FOCUS ØSTER FARIMA 83860";"-76,80";"-9.611,29";"Udført";"Nej"
"24.01.2012";"Irma Oslo Plads    75613";"-555,50";"-10.166,79";"Udført";"Nej"
"25.01.2012";"Statoil - 10742    14184";"-17,95";"-10.184,74";"Udført";"Nej"
"25.01.2012";"Irma Codanhus 2301 80581";"-156,33";"-10.341,07";"Udført";"Nej"
"25.01.2012";"FOCUS ØSTER FARIMA 84240";"-48,00";"-10.389,07";"Udført";"Nej"
"26.01.2012";"VDK DKK    99,00";"-99,00";"-10.488,07";"Udført";"Nej"
"26.01.2012";"VDK DKK    39,00";"-39,00";"-10.527,07";"Udført";"Nej"
"26.01.2012";"Vedels             69908";"-113,00";"-10.640,07";"Udført";"Nej"
"26.01.2012";"Irma Oslo Plads    20863";"-522,00";"-11.162,07";"Udført";"Nej"
"27.01.2012";"VDK DKK    99,00";"-99,00";"-11.261,07";"Udført";"Nej"
"27.01.2012";"Candy Megastore Sw 35809";"-85,00";"-11.346,07";"Udført";"Nej"
"27.01.2012";"FONA AFD. FS/110   25879";"-199,90";"-11.545,97";"Udført";"Nej"
"27.01.2012";"Illum              13662";"-420,00";"-11.965,97";"Udført";"Nej"
"27.01.2012";"Lemontblanc        80050";"-156,00";"-12.121,97";"Udført";"Nej"
"30.01.2012";"Vedels             70269";"-60,00";"-12.181,97";"Udført";"Nej"
"30.01.2012";"APOTEKET TRIANGLEN 62563";"-315,70";"-12.497,67";"Udført";"Nej"
"30.01.2012";"TRIANGEL HÆLEBAR   09673";"-29,00";"-12.526,67";"Udført";"Nej"
"30.01.2012";"onfone.dk          40331";"-50,00";"-12.576,67";"Udført";"Nej"
"30.01.2012";"onfone.dk          44940";"-25,00";"-12.601,67";"Udført";"Nej"
"30.01.2012";"Reinh. van Hauen   12336";"-117,95";"-12.719,62";"Udført";"Nej"
"30.01.2012";"VOIGT              58039";"-199,00";"-12.918,62";"Udført";"Nej"
"30.01.2012";"BR-LEGETØJ - 2165  42112";"-119,90";"-13.038,52";"Udført";"Nej"
"30.01.2012";"Tiger 37           72869";"-62,00";"-13.100,52";"Udført";"Nej"
"30.01.2012";"SILVAN             20974";"-299,95";"-13.400,47";"Udført";"Nej"
"30.01.2012";"Stadium            05485";"-314,25";"-13.714,72";"Udført";"Nej"
"30.01.2012";"Fields 174 Peak P. 29572";"-360,00";"-14.074,72";"Udført";"Nej"
"30.01.2012";"Quick Silver       36720";"-420,00";"-14.494,72";"Udført";"Nej"
"30.01.2012";"McDonald's         70038";"-304,50";"-14.799,22";"Udført";"Nej"
"30.01.2012";"gratisdns.dk       66903";"-29,70";"-14.828,92";"Udført";"Nej"
"30.01.2012";"gratisdns.dk       66904";"-29,70";"-14.858,62";"Udført";"Nej"
"30.01.2012";"gratisdns.dk       66905";"-29,70";"-14.888,32";"Udført";"Nej"
"30.01.2012";"TV 2/DANMARK       49110";"-69,00";"-14.957,32";"Udført";"Nej"
"30.01.2012";"Field's Parkering  09649";"-6,00";"-14.963,32";"Udført";"Nej"
"30.01.2012";"Irma Fr.Borggade   76472";"-341,50";"-15.304,82";"Udført";"Nej"
"30.01.2012";"Jette - Theater";"-240,00";"-15.544,82";"Udført";"Nej"
"30.01.2012";"Svømning";"-675,00";"-16.219,82";"Udført";"Nej"
"30.01.2012";"Magasin";"-500,00";"-16.719,82";"Udført";"Nej"
"30.01.2012";"Irma Oslo Plads    23063";"-688,50";"-17.408,32";"Udført";"Nej"
"31.01.2012";"budget";"-20.000,00";"-37.408,32";"Udført";"Nej"
"31.01.2012";"Lønoverførsel";"30.631,49";"-6.776,83";"Udført";"Nej"
"31.01.2012";"Automatudb. 2104-5171";"-500,00";"-7.276,83";"Udført";"Nej"
"31.01.2012";"activfoto.dk        6343";"-1.093,00";"-8.369,83";"Udført";"Nej"
"31.01.2012";"Irma Oslo Plads    23718";"-380,80";"-8.750,63";"Udført";"Nej"
"31.01.2012";"Nordisk Film Bio   74737";"-161,61";"-8.912,24";"Udført";"Nej"
"31.01.2012";"Imperial           71384";"-121,79";"-9.034,03";"Udført";"Nej"
"31.01.2012";"Ekstra til budget";"-8.500,00";"-17.534,03";"Udført";"Nej"
"01.02.2012";"Statoil - 10742    44814";"-13,95";"-17.547,98";"Udført";"Nej"
"01.02.2012";"onfone.dk          43732";"-99,00";"-17.646,98";"Udført";"Nej"
"01.02.2012";"Kundekort 4310 0125";"11.140,98";"-6.506,00";"Udført";"Nej"
"01.02.2012";"VAISENHUS APOTEK   50840";"-421,00";"-6.927,00";"Udført";"Nej"
"01.02.2012";"FONA AFD. FS/110   27177";"-149,95";"-7.076,95";"Udført";"Nej"
"01.02.2012";"Irma Illum         79943";"-265,00";"-7.341,95";"Udført";"Nej"
"01.02.2012";"Summerbirg Chocola 43326";"-229,00";"-7.570,95";"Udført";"Nej"
"01.02.2012";"Blomster Bjarne    10865";"-200,00";"-7.770,95";"Udført";"Nej"
"01.02.2012";"Magasin, Kgs Nytor 27649";"-299,95";"-8.070,90";"Udført";"Nej"
"01.02.2012";"PIZZAHUSET         47966";"-165,00";"-8.235,90";"Udført";"Nej"
"02.02.2012";"onfone.dk          42538";"-100,00";"-8.335,90";"Udført";"Nej"
"02.02.2012";"gratisdns.dk       68179";"-29,70";"-8.365,60";"Udført";"Nej"
"02.02.2012";"Lån tilbage - Jan";"18.500,00";"10.134,40";"Udført";"Nej"
"02.02.2012";"Irma Codanhus 2301 85549";"-327,50";"9.806,90";"Udført";"Nej"
"03.02.2012";"Gave til Monica";"-50,00";"9.756,90";"Udført";"Nej"
"03.02.2012";"Kruses Gastronomi  13375";"-60,00";"9.696,90";"Udført";"Nej"
"03.02.2012";"Sportmarster Søbor 19499";"-1.400,00";"8.296,90";"Udført";"Nej"
"03.02.2012";"Reinh. van Hauen   14065";"-88,50";"8.208,40";"Udført";"Nej"
"03.02.2012";"Irma Fr.Borggade   30977";"-269,00";"7.939,40";"Udført";"Nej"
"06.02.2012";"Ikea - 121, ACO    06686";"-712,00";"7.227,40";"Udført";"Nej"
"06.02.2012";"TOYS \"R\" US - 3109 87808";"-229,95";"6.997,45";"Udført";"Nej"
"06.02.2012";"emmerys            21238";"-92,00";"6.905,45";"Udført";"Nej"
"06.02.2012";"Bettina Beltner    22848";"-569,00";"6.336,45";"Udført";"Nej"
"06.02.2012";"Byman Sport        01723";"-950,00";"5.386,45";"Udført";"Nej"
"06.02.2012";"Møller & Mammen Ap 40387";"-45,00";"5.341,45";"Udført";"Nej"
"06.02.2012";"Nespresso Danmark  62785";"-300,00";"5.041,45";"Udført";"Nej"
"06.02.2012";"FONA AFD. FS/110   15021";"-539,90";"4.501,55";"Udført";"Nej"
"06.02.2012";"Irma Nørre Voldg.  73961";"-251,00";"4.250,55";"Udført";"Nej"
"06.02.2012";"Elgiganten 3031    11394";"-1.154,00";"3.096,55";"Udført";"Nej"
"06.02.2012";"FOCUS ØSTER FARIMA 89318";"-83,35";"3.013,20";"Udført";"Nej"
"06.02.2012";"Irma Oslo Plads    26717";"-445,00";"2.568,20";"Udført";"Nej"
"06.02.2012";"www.teleonline.dk   4732";"-271,00";"2.297,20";"Udført";"Nej"
"06.02.2012";"FONA AFD. FS/110   12258";"-449,95";"1.847,25";"Udført";"Nej"
"06.02.2012";"The Bagel co.      08735";"-52,00";"1.795,25";"Udført";"Nej"
"06.02.2012";"Fields 174 Peak P. 30796";"-40,00";"1.755,25";"Udført";"Nej"
"06.02.2012";"KAGEHUSET FIELDS A 85289";"-43,00";"1.712,25";"Udført";"Nej"
"06.02.2012";"Sportmaster        99324";"-499,95";"1.212,30";"Udført";"Nej"
"06.02.2012";"H&M Hennes & Mauri 65335";"-334,70";"877,60";"Udført";"Nej"
"06.02.2012";"H&M Hennes & Mauri 47422";"-528,00";"349,60";"Udført";"Nej"
"06.02.2012";"Irma Nørre Voldg.  08972";"-267,00";"82,60";"Udført";"Nej"
"07.02.2012";"Irma Nørre Voldg.  09918";"-322,50";"-239,90";"Udført";"Nej"
"07.02.2012";"Automatudb. 3121-83 7137";"-500,00";"-739,90";"Udført";"Nej"
"08.02.2012";"FOCUS ØSTER FARIMA 90738";"-92,80";"-832,70";"Udført";"Nej"
"08.02.2012";"Irma Nørre Voldg.  75123";"-216,50";"-1.049,20";"Udført";"Nej"
"08.02.2012";"FOCUS ØSTER FARIMA 90780";"-81,40";"-1.130,60";"Udført";"Nej"
"09.02.2012";"Ovf. til lån";"-11.000,00";"-12.130,60";"Udført";"Nej"
"09.02.2012";"McDonald's         29724";"-175,00";"-12.305,60";"Udført";"Nej"
"10.02.2012";"Automatudb. 6737-2757";"-1.300,00";"-13.605,60";"Udført";"Nej"
"10.02.2012";"WH-Smith T2 Pier B 14485";"-154,95";"-13.760,55";"Udført";"Nej"
"10.02.2012";"Irma Østerbrog.52  74321";"-367,50";"-14.128,05";"Udført";"Nej"
"10.02.2012";"FOCUS ØSTER FARIMA 91695";"-39,90";"-14.167,95";"Udført";"Nej"
"13.02.2012";"Vedels             72618";"-108,00";"-14.275,95";"Udført";"Nej"
"13.02.2012";"emmerys            23267";"-119,00";"-14.394,95";"Udført";"Nej"
"13.02.2012";"FOCUS ØSTER FARIMA 91944";"-93,75";"-14.488,70";"Udført";"Nej"
"13.02.2012";"Irma Fr.Borggade   87527";"-271,86";"-14.760,56";"Udført";"Nej"
"13.02.2012";"Blockbuster Video  25085";"-102,45";"-14.863,01";"Udført";"Nej"
"13.02.2012";"Vedels             72844";"-162,00";"-15.025,01";"Udført";"Nej"
"13.02.2012";"Shell Service-1189 03576";"-498,69";"-15.523,70";"Udført";"Nej"
"13.02.2012";"Irma Oslo Plads    30898";"-759,50";"-16.283,20";"Udført";"Nej"
"14.02.2012";"VDK DKK     6,00";"-6,00";"-16.289,20";"Udført";"Nej"
"14.02.2012";"VDK USD    38,34";"-219,50";"-16.508,70";"Udført";"Nej"
"14.02.2012";"Lemontblanc        81597";"-120,00";"-16.628,70";"Udført";"Nej"
"14.02.2012";"ZISAR HARIDREZZER  10347";"-285,00";"-16.913,70";"Udført";"Nej"
"14.02.2012";"Irma City 23097    65237";"-143,00";"-17.056,70";"Udført";"Nej"
"14.02.2012";"Blockbuster Video  21691";"-249,95";"-17.306,65";"Udført";"Nej"
"15.02.2012";"VDK EUR    12,99";"-97,55";"-17.404,20";"Udført";"Nej"
"15.02.2012";"FONA AFD. FS/110   33143";"-749,95";"-18.154,15";"Udført";"Nej"
"15.02.2012";"FONA AFD. FS/110   30777";"-149,95";"-18.304,10";"Udført";"Nej"
"15.02.2012";"FRISØR IVONETT     08751";"-470,00";"-18.774,10";"Udført";"Nej"
"15.02.2012";"Morten Holm        75010";"-227,00";"-19.001,10";"Udført";"Nej"
"15.02.2012";"SuperB Borgergade  26562";"-160,00";"-19.161,10";"Udført";"Nej"
"15.02.2012";"Byman Sport        01982";"-300,00";"-19.461,10";"Udført";"Nej"
"15.02.2012";"PIZZAHUSET         52975";"-219,00";"-19.680,10";"Udført";"Nej"
"16.02.2012";"7-Eleven B 21      27779";"-80,85";"-19.760,95";"Udført";"Nej"
"16.02.2012";"KILDESKOVSHALLEN   52897";"-150,00";"-19.910,95";"Udført";"Nej"
"16.02.2012";"emmerys            24407";"-120,00";"-20.030,95";"Udført";"Nej"
"16.02.2012";"VAISENHUS APOTEK   83265";"-162,75";"-20.193,70";"Udført";"Nej"
"16.02.2012";"Magasin, Kgs Nytor 00121";"-500,00";"-20.693,70";"Udført";"Nej"
"16.02.2012";"Irma 23021         34592";"-266,50";"-20.960,20";"Udført";"Nej"
"17.02.2012";"VDK DKK    12,00";"-12,00";"-20.972,20";"Udført";"Nej"
"17.02.2012";"VDK DKK   299,00";"-299,00";"-21.271,20";"Udført";"Nej"
"17.02.2012";"SPORTMASTER VIMMEL 84657";"550,00";"-20.721,20";"Udført";"Nej"
"17.02.2012";"Fuglsang & Co      09670";"-329,00";"-21.050,20";"Udført";"Nej"
"17.02.2012";"Magasin, Kgs Nytor 00126";"400,00";"-20.650,20";"Udført";"Nej"
"17.02.2012";"Fuglsang & Co      09672";"-299,00";"-20.949,20";"Udført";"Nej"
"17.02.2012";"Candy Megastore Sw 41225";"-122,50";"-21.071,70";"Udført";"Nej"
"17.02.2012";"Baresso Coffee     20492";"-284,00";"-21.355,70";"Udført";"Nej"
"17.02.2012";"Magasin, Kgs Nytor 13546";"-1.500,00";"-22.855,70";"Udført";"Nej"
"17.02.2012";"McDonald's         71681";"-322,50";"-23.178,20";"Udført";"Nej"
"17.02.2012";"FOCUS ØSTER FARIMA 94624";"-58,90";"-23.237,10";"Udført";"Nej"
"20.02.2012";"Kruses Gastronomi  14779";"-62,00";"-23.299,10";"Udført";"Nej"
"20.02.2012";"Superbest, Østerbr 01375";"-625,85";"-23.924,95";"Udført";"Nej"
"20.02.2012";"Irma Oslo Plads    63994";"-625,34";"-24.550,29";"Udført";"Nej"
"20.02.2012";"FOCUS ØSTER FARIMA 95515";"-111,40";"-24.661,69";"Udført";"Nej"
"20.02.2012";"7-Eleven B 09      28017";"-45,00";"-24.706,69";"Udført";"Nej"
"20.02.2012";"Irma Oslo Plads    82777";"-437,00";"-25.143,69";"Udført";"Nej"
"21.02.2012";"VDK DKK   167,00";"-167,00";"-25.310,69";"Udført";"Nej"
"21.02.2012";"VDK DKK     6,00";"-6,00";"-25.316,69";"Udført";"Nej"
"21.02.2012";"singtehus.dk        2055";"-890,00";"-26.206,69";"Udført";"Nej"
"21.02.2012";"Irma Oslo Plads    83212";"-463,00";"-26.669,69";"Udført";"Nej"
"22.02.2012";"Irma Oslo Plads    83585";"-183,00";"-26.852,69";"Udført";"Nej"
"22.02.2012";"LAURITZ.COM        45446";"-250,00";"-27.102,69";"Udført";"Nej"
"23.02.2012";"FOCUS ØSTER FARIMA 97331";"-58,85";"-27.161,54";"Udført";"Nej"
"23.02.2012";"Irma Oslo Plads    75901";"-456,50";"-27.618,04";"Udført";"Nej"
"24.02.2012";"Games/Karrusella   93899";"-119,00";"-27.737,04";"Udført";"Nej"
"24.02.2012";"Irma Nørre Voldg.  21662";"-500,00";"-28.237,04";"Udført";"Nej"
"27.02.2012";"FOCUS ØSTER FARIMA 98204";"-101,85";"-28.338,89";"Udført";"Nej"
"27.02.2012";"emmerys            27004";"-202,00";"-28.540,89";"Udført";"Nej"
"27.02.2012";"Nespresso Danmark  49449";"-300,00";"-28.840,89";"Udført";"Nej"
"27.02.2012";"Lemontblanc        82775";"-30,00";"-28.870,89";"Udført";"Nej"
"27.02.2012";"Irma Østerbrog.52  87946";"-154,00";"-29.024,89";"Udført";"Nej"
"27.02.2012";"7-Eleven B 14      49363";"-145,00";"-29.169,89";"Udført";"Nej"
"27.02.2012";"Vedels             75080";"-42,00";"-29.211,89";"Udført";"Nej"
"27.02.2012";"emmerys            27425";"-52,00";"-29.263,89";"Udført";"Nej"
"27.02.2012";"Irma Oslo Plads    66515";"-196,50";"-29.460,39";"Udført";"Nej"
"27.02.2012";"FOCUS ØSTER FARIMA 99182";"-45,90";"-29.506,29";"Udført";"Nej"
"27.02.2012";"BILLETNET A/S      59569";"-145,59";"-29.651,88";"Udført";"Nej"
"27.02.2012";"Baresso Coffee A/S 69815";"-38,00";"-29.689,88";"Udført";"Nej"
"28.02.2012";"VDK DKK    12,50";"-12,50";"-29.702,38";"Udført";"Nej"
"28.02.2012";"VDK DKK    99,00";"-99,00";"-29.801,38";"Udført";"Nej"
"28.02.2012";"VDK DKK    99,00";"-99,00";"-29.900,38";"Udført";"Nej"
"28.02.2012";"onfone.dk          55417";"-50,00";"-29.950,38";"Udført";"Nej"
"28.02.2012";"onfone.dk          55457";"-50,00";"-30.000,38";"Udført";"Nej"
"28.02.2012";"onfone.dk          58534";"-25,00";"-30.025,38";"Udført";"Nej"
"28.02.2012";"Irma Oslo Plads    66988";"-361,97";"-30.387,35";"Udført";"Nej"
"29.02.2012";"budget";"-20.000,00";"-50.387,35";"Udført";"Nej"
"29.02.2012";"Lønoverførsel";"30.631,49";"-19.755,86";"Udført";"Nej"
"29.02.2012";"Codan Forsikring A 00577";"-150,00";"-19.905,86";"Udført";"Nej"
"29.02.2012";"Irma Nørre Voldg.  25937";"-311,00";"-20.216,86";"Udført";"Nej"
"29.02.2012";"Lånt til SPG";"-18.000,00";"-38.216,86";"Udført";"Nej"
"29.02.2012";"Ovf. Marts 2012";"33.000,00";"-5.216,86";"Udført";"Nej"
"29.02.2012";"Mastercard";"-5.000,00";"-10.216,86";"Udført";"Nej"
"29.02.2012";"Ovf. til budget";"-2.200,00";"-12.416,86";"Udført";"Nej"
"01.03.2012";"Vedels             75691";"-118,00";"-12.534,86";"Udført";"Nej"
"01.03.2012";"onfone.dk          85283";"-99,00";"-12.633,86";"Udført";"Nej"
"01.03.2012";"Netto Sølvgade     96699";"-118,57";"-12.752,43";"Udført";"Nej"
"02.03.2012";"Reinh. van Hauen   21785";"-56,90";"-12.809,33";"Udført";"Nej"
"02.03.2012";"Candy Megastore Sw 45270";"-143,00";"-12.952,33";"Udført";"Nej"
"02.03.2012";"Bagels Corner      41512";"-60,00";"-13.012,33";"Udført";"Nej"
"02.03.2012";"Lemontblanc        83418";"-156,00";"-13.168,33";"Udført";"Nej"
"04.03.2012";"Lån tilbage SPG";"18.000,00";"4.831,67";"Udført";"Nej"
"04.03.2012";"Ovf. til budget";"-12.600,00";"-7.768,33";"Udført";"Nej"
"05.03.2012";"Automatudb. 2104-0210";"-1.500,00";"-9.268,33";"Udført";"Nej"
"05.03.2012";"Asserbo By Vandværk AmBa";"-1.237,39";"-10.505,72";"Udført";"Nej"
"05.03.2012";"Vedels             76100";"-36,00";"-10.541,72";"Udført";"Nej"
"05.03.2012";"FOCUS ØSTER FARIMA 01930";"-28,90";"-10.570,62";"Udført";"Nej"
"05.03.2012";"Irma 23021         46864";"-437,50";"-11.008,12";"Udført";"Nej"
"05.03.2012";"emmerys            29419";"-74,00";"-11.082,12";"Udført";"Nej"
"05.03.2012";"KILDESKOVSHALLEN   57468";"-450,00";"-11.532,12";"Udført";"Nej"
"05.03.2012";"emmerys            29659";"-19,00";"-11.551,12";"Udført";"Nej"
"05.03.2012";"FOCUS ØSTER FARIMA 02484";"-146,80";"-11.697,92";"Udført";"Nej"
"05.03.2012";"Irma Oslo Plads    81088";"-498,52";"-12.196,44";"Udført";"Nej"
"05.03.2012";"Tiger 37           59706";"-110,00";"-12.306,44";"Udført";"Nej"
"05.03.2012";"FONA AFD. FS/110   36762";"-499,90";"-12.806,34";"Udført";"Nej"
"05.03.2012";"Søstjernen         31350";"-400,00";"-13.206,34";"Udført";"Nej"
"05.03.2012";"Irma Oslo Plads    87189";"-497,00";"-13.703,34";"Udført";"Nej"
"05.03.2012";"Power Training";"-600,00";"-14.303,34";"Udført";"Nej"
"06.03.2012";"VDK DKK   299,00";"-299,00";"-14.602,34";"Udført";"Nej"
"06.03.2012";"Irma Oslo Plads    43187";"-393,00";"-14.995,34";"Udført";"Nej"
"06.03.2012";"Tiger 37           68590";"-30,00";"-15.025,34";"Udført";"Nej"
"07.03.2012";"Blockbuster Video  29091";"-349,95";"-15.375,29";"Udført";"Nej"
"07.03.2012";"Irma Fr.Borggade   68083";"-313,50";"-15.688,79";"Udført";"Nej"
"08.03.2012";"Magasin, Kgs Nytor 44986";"-293,60";"-15.982,39";"Udført";"Nej"
"08.03.2012";"Magasin, Kgs Nytor 31077";"-59,95";"-16.042,34";"Udført";"Nej"
"08.03.2012";"Tobias Lind Madsen";"-200,00";"-16.242,34";"Udført";"Nej"
"09.03.2012";"Automatudb. 6737-6294";"-1.500,00";"-17.742,34";"Udført";"Nej"
"09.03.2012";"Candy Megastore Sw 47598";"-128,00";"-17.870,34";"Udført";"Nej"
"09.03.2012";"H & M              03238";"-8,00";"-17.878,34";"Udført";"Nej"
"09.03.2012";"H. SKJALM P.       83822";"-418,00";"-18.296,34";"Udført";"Nej"
"09.03.2012";"Lemontblanc        84162";"-30,00";"-18.326,34";"Udført";"Nej"
"09.03.2012";"SuperB Borgergade  50439";"-281,95";"-18.608,29";"Udført";"Nej"
"09.03.2012";"Cykelmageren       15738";"-75,00";"-18.683,29";"Udført";"Nej"
"09.03.2012";"onfone.dk          48268";"-50,00";"-18.733,29";"Udført";"Nej"
"12.03.2012";"VDK DKK   150,98";"-150,98";"-18.884,27";"Udført";"Nej"
"12.03.2012";"Nordisk Film Bio   45718";"-141,59";"-19.025,86";"Udført";"Nej"
"12.03.2012";"Irma Oslo Plads    83762";"-410,30";"-19.436,16";"Udført";"Nej"
"12.03.2012";"FOCUS ØSTER FARIMA 05474";"-66,40";"-19.502,56";"Udført";"Nej"
"12.03.2012";"Halifax            98396";"-346,00";"-19.848,56";"Udført";"Nej"
"12.03.2012";"Imperial           00133";"-140,11";"-19.988,67";"Udført";"Nej"
"12.03.2012";"Blockbuster Video  83352";"-99,00";"-20.087,67";"Udført";"Nej"
"12.03.2012";"Paradis Trianglen  48382";"-100,00";"-20.187,67";"Udført";"Nej"
"12.03.2012";"Magasin, Kgs Nytor 40435";"-349,00";"-20.536,67";"Udført";"Nej"
"12.03.2012";"Irma Oslo Plads    88954";"-379,75";"-20.916,42";"Udført";"Nej"
"13.03.2012";"VDK DKK    60,00";"-60,00";"-20.976,42";"Udført";"Nej"
"13.03.2012";"Irma Oslo Plads    27642";"-327,50";"-21.303,92";"Udført";"Nej"
"13.03.2012";"Magasin, Kgs Nytor 40514";"-349,00";"-21.652,92";"Udført";"Nej"
"14.03.2012";"billetto.dk        0r435";"-537,13";"-22.190,05";"Udført";"Nej"
"14.03.2012";"Paradis Trianglen  48653";"-33,00";"-22.223,05";"Udført";"Nej"
"14.03.2012";"SPORTMASTER A/S    46407";"-1.579,00";"-23.802,05";"Udført";"Nej"
"14.03.2012";"PIZZAHUSET         63968";"-216,00";"-24.018,05";"Udført";"Nej"
"15.03.2012";"VDK EUR    12,99";"-97,55";"-24.115,60";"Udført";"Nej"
"15.03.2012";"McDonald's         75498";"-380,00";"-24.495,60";"Udført";"Nej"
"15.03.2012";"FOCUS ØSTER FARIMA 08066";"-93,25";"-24.588,85";"Udført";"Nej"
"16.03.2012";"Baresso Coffee A/S 74628";"-107,00";"-24.695,85";"Udført";"Nej"
"16.03.2012";"Irma Østerbrog.52  06817";"-172,50";"-24.868,35";"Udført";"Nej"
"16.03.2012";"FOCUS ØSTER FARIMA 08622";"-69,35";"-24.937,70";"Udført";"Nej"
"19.03.2012";"emmerys            33605";"-128,00";"-25.065,70";"Udført";"Nej"
"19.03.2012";"LABCPH             04975";"-649,00";"-25.714,70";"Udført";"Nej"
"19.03.2012";"Irma Oslo Plads    89558";"-451,50";"-26.166,20";"Udført";"Nej"
"19.03.2012";"Happy Kebab Danmar 00226";"-40,00";"-26.206,20";"Udført";"Nej"
"19.03.2012";"CDON AB            12824";"-39,00";"-26.245,20";"Udført";"Nej"
"19.03.2012";"onfone.dk          89421";"-100,00";"-26.345,20";"Udført";"Nej"
"19.03.2012";"Paradis Trianglen  49092";"-120,00";"-26.465,20";"Udført";"Nej"
"19.03.2012";"Dag H              18406";"-230,00";"-26.695,20";"Udført";"Nej"
"19.03.2012";"LABCPH             05019";"-1.048,00";"-27.743,20";"Udført";"Nej"
"19.03.2012";"Irma Oslo Plads    73747";"-921,00";"-28.664,20";"Udført";"Nej"
"20.03.2012";"VDK DKK    39,00";"-39,00";"-28.703,20";"Udført";"Nej"
"20.03.2012";"VDK DKK    39,00";"-39,00";"-28.742,20";"Udført";"Nej"
"20.03.2012";"7-Eleven B 01      22386";"-55,90";"-28.798,10";"Udført";"Nej"
"20.03.2012";"ComputerSalg A/S   32058";"-456,36";"-29.254,46";"Udført";"Nej"
"20.03.2012";"Irma Oslo Plads    88249";"-217,00";"-29.471,46";"Udført";"Nej"
"21.03.2012";"Baresso Coffee A/S 11056";"-35,00";"-29.506,46";"Udført";"Nej"
"21.03.2012";"Irma Oslo Plads    29727";"-251,00";"-29.757,46";"Udført";"Nej"
"22.03.2012";"Paradis Trianglen  49535";"-100,00";"-29.857,46";"Udført";"Nej"
"22.03.2012";"Fashionistas ApS   15137";"-450,00";"-30.307,46";"Udført";"Nej"
"22.03.2012";"Lemontblanc        85638";"-127,00";"-30.434,46";"Udført";"Nej"
"22.03.2012";"pure shop a/s      40487";"-248,00";"-30.682,46";"Udført";"Nej"
"22.03.2012";"SuperB Borgergade  37789";"-27,00";"-30.709,46";"Udført";"Nej"
"22.03.2012";"SuperB Borgergade  57162";"-187,15";"-30.896,61";"Udført";"Nej"
"22.03.2012";"PIZZAHUSET         67249";"-54,00";"-30.950,61";"Udført";"Nej"
"23.03.2012";"Gebr. Heinemann    15323";"-172,00";"-31.122,61";"Udført";"Nej"
"23.03.2012";"JOE & THE JUICE CP 37379";"-38,00";"-31.160,61";"Udført";"Nej"
"23.03.2012";"Candy Megastore Sw 70204";"-171,00";"-31.331,61";"Udført";"Nej"
"23.03.2012";"Mcdonalds Fr.bergg 50772";"-183,00";"-31.514,61";"Udført";"Nej"
"23.03.2012";"DSB Kastrup AUT    94057";"-145,00";"-31.659,61";"Udført";"Nej"
"26.03.2012";"Vedels             79627";"-184,00";"-31.843,61";"Udført";"Nej"
"26.03.2012";"Nordisk Film Bio   54055";"-291,74";"-32.135,35";"Udført";"Nej"
"26.03.2012";"Shawarma ApS       29356";"-217,00";"-32.352,35";"Udført";"Nej"
"26.03.2012";"DAGMAR TEATRET A/S 61367";"-96,00";"-32.448,35";"Udført";"Nej"
"26.03.2012";"Vedels             79829";"-48,00";"-32.496,35";"Udført";"Nej"
"26.03.2012";"FOCUS ØSTER FARIMA 12894";"-72,85";"-32.569,20";"Udført";"Nej"
"26.03.2012";"Fashionistas ApS   15253";"-80,00";"-32.649,20";"Udført";"Nej"
"26.03.2012";"Fælledparkens Kios 23629";"-18,00";"-32.667,20";"Udført";"Nej"
"26.03.2012";"Morten Holm        05758";"-37,00";"-32.704,20";"Udført";"Nej"
"26.03.2012";"Illum              22815";"-223,50";"-32.927,70";"Udført";"Nej"
"26.03.2012";"JOE & THE JUICE    15230";"-48,00";"-32.975,70";"Udført";"Nej"
"26.03.2012";"FONA AFD. FS/110   45515";"-84,95";"-33.060,65";"Udført";"Nej"
"26.03.2012";"Irma Oslo Plads    90422";"-615,00";"-33.675,65";"Udført";"Nej"
"26.03.2012";"iRep.DK            06841";"-1.000,00";"-34.675,65";"Udført";"Nej"
"26.03.2012";"Hyttetur 2.y";"-440,00";"-35.115,65";"Udført";"Nej"
"26.03.2012";"Dankort PH 2100 0384772";"-40,00";"-35.155,65";"Udført";"Nej"
"26.03.2012";"Irma Oslo Plads    31507";"-453,50";"-35.609,15";"Udført";"Nej"
"27.03.2012";"VDK DKK   169,00";"-169,00";"-35.778,15";"Udført";"Nej"
"27.03.2012";"VDK DKK    99,00";"-99,00";"-35.877,15";"Udført";"Nej"
"27.03.2012";"VDK DKK    99,00";"-99,00";"-35.976,15";"Udført";"Nej"
"27.03.2012";"Irma Oslo Plads    91320";"-475,50";"-36.451,65";"Udført";"Nej"
"28.03.2012";"onfone.dk          42829";"-50,00";"-36.501,65";"Udført";"Nej"
"28.03.2012";"Automatudb. 2104-0277";"-500,00";"-37.001,65";"Udført";"Nej"
"28.03.2012";"onfone.dk          94022";"-25,00";"-37.026,65";"Udført";"Nej"
"28.03.2012";"FOCUS ØSTER FARIMA 14857";"-173,95";"-37.200,60";"Udført";"Nej"
"30.03.2012";"budget";"-20.000,00";"-57.200,60";"Udført";"Nej"
"30.03.2012";"Iform";"-69,45";"-57.270,05";"Udført";"Nej"
"30.03.2012";"Lønoverførsel";"31.131,49";"-26.138,56";"Udført";"Nej"
"30.03.2012";"Schantz Data A/S";"1.000,00";"-25.138,56";"Udført";"Nej"
"30.03.2012";"Jette løn - april";"15.000,00";"-10.138,56";"Udført";"Nej"
"30.03.2012";"Ovf. til budget";"-6.000,00";"-16.138,56";"Udført";"Nej"
"30.03.2012";"Jagttegn";"-530,00";"-16.668,56";"Udført";"Nej"
"30.03.2012";"Dag H              26600";"-1.040,00";"-17.708,56";"Udført";"Nej"
"30.03.2012";"Irma Oslo Plads    93215";"-649,50";"-18.358,06";"Udført";"Nej"
"30.03.2012";"ZISAR HARIDREZZER  11182";"-420,00";"-18.778,06";"Udført";"Nej"
"30.03.2012";"Candy Megastore Sw 54349";"-102,50";"-18.880,56";"Udført";"Nej"
"30.03.2012";"The Bagel co.      13069";"-48,00";"-18.928,56";"Udført";"Nej"
"30.03.2012";"Delizia Pizza      01522";"-84,00";"-19.012,56";"Udført";"Nej"
"30.03.2012";"Danske Ekstra-pakke";"-75,00";"-19.087,56";"Udført";"Nej"
"30.03.2012";"Rente";"0,28";"-19.087,28";"Udført";"Nej"
"30.03.2012";"Rente";"-379,17";"-19.466,45";"Udført";"Nej"
"02.04.2012";"FONA AFD. FS/110   47621";"-759,35";"-20.225,80";"Udført";"Nej"
"02.04.2012";"Morten Holm        89192";"-99,00";"-20.324,80";"Udført";"Nej"
"02.04.2012";"DSB 7-Eleven Øster 55720";"-121,40";"-20.446,20";"Udført";"Nej"
"02.04.2012";"Vedels             81058";"-70,00";"-20.516,20";"Udført";"Nej"
"02.04.2012";"FOCUS ØSTER FARIMA 16396";"-66,90";"-20.583,10";"Udført";"Nej"
"02.04.2012";"Nordisk Film Bio   20655";"-206,66";"-20.789,76";"Udført";"Nej"
"02.04.2012";"onfone.dk          50238";"-99,00";"-20.888,76";"Udført";"Nej"
"02.04.2012";"Illum              08677";"-525,00";"-21.413,76";"Udført";"Nej"
"02.04.2012";"Illum              08709";"-750,00";"-22.163,76";"Udført";"Nej"
"02.04.2012";"Morten Holm        89895";"-37,00";"-22.200,76";"Udført";"Nej"
"02.04.2012";"Burger King        76068";"-178,00";"-22.378,76";"Udført";"Nej"
"02.04.2012";"Foot Locker 09253  18762";"-249,95";"-22.628,71";"Udført";"Nej"
"02.04.2012";"PALADS TEATRET     01771";"-121,96";"-22.750,67";"Udført";"Nej"
"02.04.2012";"Fakta 332          46561";"-18,90";"-22.769,57";"Udført";"Nej"
"02.04.2012";"Dansk Shell- 1633  04152";"-522,74";"-23.292,31";"Udført";"Nej"
"02.04.2012";"FOTO-HUSET         48678";"-13.728,00";"-37.020,31";"Udført";"Nej"
"02.04.2012";"LABCPH             05368";"-350,00";"-37.370,31";"Udført";"Nej"
"02.04.2012";"Player ApS         51339";"-580,00";"-37.950,31";"Udført";"Nej"
"02.04.2012";"Irma Oslo Plads    58991";"-608,00";"-38.558,31";"Udført";"Nej"
"02.04.2012";"Field's Parkering  50831";"-6,00";"-38.564,31";"Udført";"Nej"
"02.04.2012";"Wettendorff        13803";"-180,00";"-38.744,31";"Udført";"Nej"
"03.04.2012";"VDK DKK     6,00";"-6,00";"-38.750,31";"Udført";"Nej"
"03.04.2012";"Automatudb. 2104-1399";"-500,00";"-39.250,31";"Udført";"Nej"
"03.04.2012";"Automatudb. 5479-3662";"-1.200,00";"-40.450,31";"Udført";"Nej"
"03.04.2012";"KILDESKOVSHALLEN   64111";"-300,00";"-40.750,31";"Udført";"Nej"
"03.04.2012";"Kruses Gastronomi  20268";"-39,00";"-40.789,31";"Udført";"Nej"
"03.04.2012";"Dag H              29332";"-91,00";"-40.880,31";"Udført";"Nej"
"03.04.2012";"fotohusetvirum.dk  38696";"-3.180,00";"-44.060,31";"Udført";"Nej"
"03.04.2012";"emmerys            38758";"-157,00";"-44.217,31";"Udført";"Nej"
"03.04.2012";"emmerys            38760";"-26,00";"-44.243,31";"Udført";"Nej"
"03.04.2012";"McDonald's         78481";"-299,50";"-44.542,81";"Udført";"Nej"
"04.04.2012";"VDK DKK    39,00";"-39,00";"-44.581,81";"Udført";"Nej"
"04.04.2012";"FOCUS ØSTER FARIMA 17625";"-53,35";"-44.635,16";"Udført";"Nej"
"04.04.2012";"Ovf. tilbage";"18.000,00";"-26.635,16";"Udført";"Nej"
"04.04.2012";"Lederen";"-2.887,00";"-29.522,16";"Udført";"Nej"
"04.04.2012";"Change - Østerbrog 68853";"-359,90";"-29.882,06";"Udført";"Nej"
"04.04.2012";"Shoots             33687";"-850,00";"-30.732,06";"Udført";"Nej"
"04.04.2012";"CINEMAXX FISKETORV 10263";"-136,56";"-30.868,62";"Udført";"Nej"
"04.04.2012";"Irma Oslo Plads    41770";"-84,00";"-30.952,62";"Udført";"Nej"
"04.04.2012";"Irma Oslo Plads    60418";"-1.119,33";"-32.071,95";"Udført";"Nej"
"04.04.2012";"FOCUS ØSTER FARIMA 17841";"-88,50";"-32.160,45";"Udført";"Nej"
"04.04.2012";"E BILLET A/S       87311";"-141,59";"-32.302,04";"Udført";"Nej"
"10.04.2012";"Lønover. 1702640527";"66.021,00";"33.718,96";"Udført";"Nej"
"10.04.2012";"Paradis Trianglen  51434";"-200,00";"33.518,96";"Udført";"Nej"
"10.04.2012";"Trianglen Kiosk    81759";"-20,00";"33.498,96";"Udført";"Nej"
"10.04.2012";"FOODSHOP NO. 55 Ap 85415";"-182,00";"33.316,96";"Udført";"Nej"
"10.04.2012";"emmerys            39459";"-100,00";"33.216,96";"Udført";"Nej"
"10.04.2012";"FOCUS ØSTER FARIMA 18424";"-104,75";"33.112,21";"Udført";"Nej"
"10.04.2012";"A. BUSCK, KBH      70194";"-45,85";"33.066,36";"Udført";"Nej"
"10.04.2012";"Morten Holm        91450";"-87,00";"32.979,36";"Udført";"Nej"
"10.04.2012";"Player ApS         52097";"-500,00";"32.479,36";"Udført";"Nej"
"10.04.2012";"LABCPH             05537";"-1.649,00";"30.830,36";"Udført";"Nej"
"10.04.2012";"FONA AFD. FS/110   49995";"-199,95";"30.630,41";"Udført";"Nej"
"10.04.2012";"Lemontblanc        87290";"-104,00";"30.526,41";"Udført";"Nej"
"10.04.2012";"Irma Oslo Plads    94619";"-358,00";"30.168,41";"Udført";"Nej"
"10.04.2012";"Vedels             81598";"-117,00";"30.051,41";"Udført";"Nej"
"10.04.2012";"FOCUS ØSTER FARIMA 19127";"-40,90";"30.010,51";"Udført";"Nej"
"10.04.2012";"E BILLET A/S       41043";"-156,60";"29.853,91";"Udført";"Nej"
"10.04.2012";"CINEMAXX FISKETORV 10112";"-64,94";"29.788,97";"Udført";"Nej"
"10.04.2012";"Baresso Coffee A/S 17684";"-187,00";"29.601,97";"Udført";"Nej"
"10.04.2012";"onfone.dk          57376";"-100,00";"29.501,97";"Udført";"Nej"
"10.04.2012";"FOCUS ØSTER FARIMA 20119";"-176,65";"29.325,32";"Udført";"Nej"
"10.04.2012";"gratisdns.dk       85888";"-100,55";"29.224,77";"Udført";"Nej"
"10.04.2012";"Melausmykker.dk";"-90,00";"29.134,77";"Udført";"Nej"
"10.04.2012";"Reinh. van Hauen   32350";"-46,95";"29.087,82";"Udført";"Nej"
"10.04.2012";"Irma Oslo Plads    60929";"-653,50";"28.434,32";"Udført";"Nej"
"10.04.2012";"SkatePro ApS       23675";"-1.075,00";"27.359,32";"Udført";"Nej"
"10.04.2012";"labforum.dk        12141";"-897,00";"26.462,32";"Udført";"Nej"
"10.04.2012";"Irma Oslo Plads    61401";"-699,00";"25.763,32";"Udført";"Nej"
"10.04.2012";"Nespresso Danmark  42391";"-594,00";"25.169,32";"Udført";"Nej"
"11.04.2012";"VDK DKK     6,00";"-6,00";"25.163,32";"Udført";"Nej"
"11.04.2012";"VDK DKK    39,00";"-39,00";"25.124,32";"Udført";"Nej"
"11.04.2012";"Netto Sølvgade     12592";"-89,40";"25.034,92";"Udført";"Nej"
"12.04.2012";"Overførsel";"356,00";"25.390,92";"Udført";"Nej"
"12.04.2012";"Fashionistas ApS   16978";"-1.000,00";"24.390,92";"Udført";"Nej"
"12.04.2012";"Irma Oslo Plads    62376";"-270,00";"24.120,92";"Udført";"Nej"
"12.04.2012";"Paradis Trianglen  51966";"-63,00";"24.057,92";"Udført";"Nej"
"13.04.2012";"Lemontblanc        87896";"-201,00";"23.856,92";"Udført";"Nej"
"13.04.2012";"Candy Megastore Sw 72417";"-106,50";"23.750,42";"Udført";"Nej"
"13.04.2012";"FONA AFD. FS/110   46148";"-199,90";"23.550,52";"Udført";"Nej"
"16.04.2012";"Vedels             82485";"-136,00";"23.414,52";"Udført";"Nej"
"16.04.2012";"Magasin, Kgs Nytor 57845";"-80,00";"23.334,52";"Udført";"Nej"
"16.04.2012";"Magasin, Kgs Nytor 69828";"-430,00";"22.904,52";"Udført";"Nej"
"16.04.2012";"Morten Holm        37182";"-37,00";"22.867,52";"Udført";"Nej"
"16.04.2012";"MATAS - 14427      42438";"-219,85";"22.647,67";"Udført";"Nej"
"16.04.2012";"Hennes & Mauritz   92865";"-258,90";"22.388,77";"Udført";"Nej"
"16.04.2012";"Hennes & mauritz   36608";"-69,95";"22.318,82";"Udført";"Nej"
"16.04.2012";"iRep.DK            07496";"-400,00";"21.918,82";"Udført";"Nej"
"16.04.2012";"Rally Point Tactic 03582";"-599,00";"21.319,82";"Udført";"Nej"
"16.04.2012";"FONA AFD. FS/110   51471";"-89,95";"21.229,87";"Udført";"Nej"
"16.04.2012";"Magasin, Kgs Nytor 27812";"-359,00";"20.870,87";"Udført";"Nej"
"16.04.2012";"Magasin, Kgs Nytor 18112";"-300,00";"20.570,87";"Udført";"Nej"
"16.04.2012";"Irma Oslo Plads    80594";"-505,00";"20.065,87";"Udført";"Nej"
"16.04.2012";"Blockbuster Video  90597";"-303,72";"19.762,15";"Udført";"Nej"
"16.04.2012";"emmerys            41745";"-111,00";"19.651,15";"Udført";"Nej"
"16.04.2012";"Familieboden       07858";"-52,00";"19.599,15";"Udført";"Nej"
"16.04.2012";"FOCUS ØSTER FARIMA 23209";"-43,00";"19.556,15";"Udført";"Nej"
"16.04.2012";"FOCUS ØSTER FARIMA 23290";"-134,40";"19.421,75";"Udført";"Nej"
"16.04.2012";"SkatePro ApS       25556";"-437,00";"18.984,75";"Udført";"Nej"
"16.04.2012";"Tria Deli          28599";"-45,00";"18.939,75";"Udført";"Nej"
"16.04.2012";"Irma Oslo Plads    96158";"-333,00";"18.606,75";"Udført";"Nej"
"16.04.2012";"McDonald's         48868";"-31,00";"18.575,75";"Udført";"Nej"
"17.04.2012";"Automatudb. 3121-83 0351";"-500,00";"18.075,75";"Udført";"Nej"
"17.04.2012";"Irma Oslo Plads    98825";"-467,99";"17.607,76";"Udført";"Nej"
"18.04.2012";"Schantz Data A/S";"400,00";"18.007,76";"Udført";"Nej"
"18.04.2012";"Akasse/Fagligt ktg.";"1.358,00";"19.365,76";"Udført";"Nej"
"18.04.2012";"Paradis Trianglen  52469";"-200,00";"19.165,76";"Udført";"Nej"
"18.04.2012";"KBL";"-300,00";"18.865,76";"Udført";"Nej"
"18.04.2012";"FOCUS ØSTER FARIMA 24868";"-100,85";"18.764,91";"Udført";"Nej"
"18.04.2012";"PULCINELLA PIZZARI 40285";"-156,00";"18.608,91";"Udført";"Nej"
"18.04.2012";"www.detfrievalg.co 56970";"-63,10";"18.545,81";"Udført";"Nej"
"18.04.2012";"www.detfrievalg.co 57425";"-1.783,23";"16.762,58";"Udført";"Nej"
"18.04.2012";"www.detfrievalg.co 57837";"-128,58";"16.634,00";"Udført";"Nej"
"19.04.2012";"Irma Codanhus 2301 77693";"-72,00";"16.562,00";"Udført";"Nej"
"19.04.2012";"LABCPH             05780";"-350,00";"16.212,00";"Udført";"Nej"
"19.04.2012";"Irma Østerbrog.52  38720";"-342,50";"15.869,50";"Udført";"Nej"
"20.04.2012";"OVERSKYDENDE SKAT";"23.980,00";"39.849,50";"Udført";"Nej"
"20.04.2012";"Vedels             83515";"-42,00";"39.807,50";"Udført";"Nej"
"20.04.2012";"MATAS - 14420      89006";"-119,95";"39.687,55";"Udført";"Nej"
"20.04.2012";"Candy Megastore Sw 72823";"-100,00";"39.587,55";"Udført";"Nej"
"20.04.2012";"LABCPH             05821";"-599,00";"38.988,55";"Udført";"Nej"
"20.04.2012";"H & M              02875";"-139,80";"38.848,75";"Udført";"Nej"
"20.04.2012";"Lemontblanc        88696";"-156,00";"38.692,75";"Udført";"Nej"
"20.04.2012";"Shawarma ApS       44588";"-59,00";"38.633,75";"Udført";"Nej"
"20.04.2012";"Irma Nørre Voldg.  67802";"-172,50";"38.461,25";"Udført";"Nej"
"23.04.2012";"Reinh. van Hauen   35385";"-97,95";"38.363,30";"Udført";"Nej"
"23.04.2012";"APOTEKET TRIANGLEN 15880";"-199,25";"38.164,05";"Udført";"Nej"
"23.04.2012";"Parkering Kbh VB-B 35938";"-10,50";"38.153,55";"Udført";"Nej"
"23.04.2012";"Reinh. van Hauen   35353";"-104,75";"38.048,80";"Udført";"Nej"
"23.04.2012";"LEGETØJ A/B        83979";"-249,95";"37.798,85";"Udført";"Nej"
"23.04.2012";"Baresso Coffee A/S 84154";"-67,00";"37.731,85";"Udført";"Nej"
"23.04.2012";"Irma Oslo Plads    00936";"-688,75";"37.043,10";"Udført";"Nej"
"23.04.2012";"Irma Oslo Plads    44583";"-82,00";"36.961,10";"Udført";"Nej"
"23.04.2012";"Parkering Kbh IØ   28055";"-10,50";"36.950,60";"Udført";"Nej"
"23.04.2012";"Baresso Coffee A/S 84234";"-48,00";"36.902,60";"Udført";"Nej"
"23.04.2012";"IRMA RYESGADE 60   89461";"-408,00";"36.494,60";"Udført";"Nej"
"23.04.2012";"emmerys            44205";"-95,00";"36.399,60";"Udført";"Nej"
"23.04.2012";"Sølvtorvets Værktø 34263";"-95,00";"36.304,60";"Udført";"Nej"
"23.04.2012";"SkatePro ApS       27135";"-169,00";"36.135,60";"Udført";"Nej"
"23.04.2012";"labforum.dk        12318";"-999,00";"35.136,60";"Udført";"Nej"
"23.04.2012";"Irma Oslo Plads    97596";"-395,00";"34.741,60";"Udført";"Nej"
"24.04.2012";"VDK DKK    39,00";"-39,00";"34.702,60";"Udført";"Nej"
"24.04.2012";"Automatudb. 2115-3623";"-1.000,00";"33.702,60";"Udført";"Nej"
"24.04.2012";"Dag H              42717";"-229,50";"33.473,10";"Udført";"Nej"
"24.04.2012";"Irma Oslo Plads    68870";"-323,75";"33.149,35";"Udført";"Nej"
"24.04.2012";"Bonito I/S v/Björn  1764";"-847,00";"32.302,35";"Udført";"Nej"
"25.04.2012";"FOCUS ØSTER FARIMA 28438";"-53,95";"32.248,40";"Udført";"Nej"
"25.04.2012";"PULCINELLA PIZZARI 40504";"-204,00";"32.044,40";"Udført";"Nej"
"26.04.2012";"7-Eleven B 01      08628";"-32,95";"32.011,45";"Udført";"Nej"
"26.04.2012";"FOCUS ØSTER FARIMA 28796";"-27,00";"31.984,45";"Udført";"Nej"
"26.04.2012";"emmerys            45403";"-45,00";"31.939,45";"Udført";"Nej"
"26.04.2012";"Faraos Cigarer     04693";"-348,00";"31.591,45";"Udført";"Nej"
"26.04.2012";"Irma Nørre Voldg.  94906";"-375,50";"31.215,95";"Udført";"Nej"
"27.04.2012";"Dag H              44591";"-213,50";"31.002,45";"Udført";"Nej"
"27.04.2012";"Candy Megastore Sw 73175";"-48,00";"30.954,45";"Udført";"Nej"
"27.04.2012";"Summerbirg Chocola 51093";"-229,00";"30.725,45";"Udført";"Nej"
"27.04.2012";"H & M              48028";"-607,75";"30.117,70";"Udført";"Nej"
"27.04.2012";"Lemontblanc        89423";"-134,00";"29.983,70";"Udført";"Nej"
"27.04.2012";"Magasin, Kgs Nytor 20422";"-150,00";"29.833,70";"Udført";"Nej"
"27.04.2012";"Ovf. Skat - Jette";"7.275,00";"37.108,70";"Udført";"Nej"
"27.04.2012";"ZISAR HARIDREZZER  11690";"-420,00";"36.688,70";"Udført";"Nej"
"27.04.2012";"Efterlønspenge";"66.000,00";"102.688,70";"Udført";"Nej"
"27.04.2012";"Ovf. til Budget";"-10.000,00";"92.688,70";"Udført";"Nej"
"30.04.2012";"budget";"-20.000,00";"72.688,70";"Udført";"Nej"
"30.04.2012";"Lønoverførsel";"43.766,01";"116.454,71";"Udført";"Nej"
"30.04.2012";"FOCUS ØSTER FARIMA 29521";"-53,90";"116.400,81";"Udført";"Nej"
"30.04.2012";"Vedels             85001";"-48,00";"116.352,81";"Udført";"Nej"
"30.04.2012";"Bella Center A/S   73627";"-160,00";"116.192,81";"Udført";"Nej"
"30.04.2012";"onfone.dk          31131";"-50,00";"116.142,81";"Udført";"Nej"
"30.04.2012";"onfone.dk          63172";"-50,00";"116.092,81";"Udført";"Nej"
"30.04.2012";"emmerys            45992";"-139,00";"115.953,81";"Udført";"Nej"
"30.04.2012";"FRILUFTSLAND A/S   03055";"-698,00";"115.255,81";"Udført";"Nej"
"30.04.2012";"NEYE(40)-VIMMELSKA 68963";"-349,00";"114.906,81";"Udført";"Nej"
"30.04.2012";"SPORTMASTER VIMMEL 97745";"-450,00";"114.456,81";"Udført";"Nej"
"30.04.2012";"Magasin, Kgs Nytor 00285";"-5.000,00";"109.456,81";"Udført";"Nej"
"30.04.2012";"Irma Oslo Plads    04332";"-904,50";"108.552,31";"Udført";"Nej"
"30.04.2012";"FOCUS ØSTER FARIMA 30192";"-20,00";"108.532,31";"Udført";"Nej"
"30.04.2012";"Jarsbo & Juhl I/S  13953";"-25,00";"108.507,31";"Udført";"Nej"
"30.04.2012";"Paradis Trianglen  14538";"-60,00";"108.447,31";"Udført";"Nej"
"30.04.2012";"Baresso Coffee A/S 85979";"-96,00";"108.351,31";"Udført";"Nej"
"30.04.2012";"BYMAN CYKLERS EFTF 62313";"-90,00";"108.261,31";"Udført";"Nej"
"30.04.2012";"Irma Oslo Plads    87425";"-347,00";"107.914,31";"Udført";"Nej"
"30.04.2012";"Ovf. til konto";"80.000,00";"187.914,31";"Udført";"Nej"
"30.04.2012";"Indbetaling";"-100.000,00";"87.914,31";"Udført";"Nej"
"30.04.2012";"Ovf. til SPG - Dep.";"-48.000,00";"39.914,31";"Udført";"Nej"
"30.04.2012";"Ovf. til SPG";"-19.000,00";"20.914,31";"Udført";"Nej"
"01.05.2012";"Automatudb. 2104-0005";"-2.000,00";"18.914,31";"Udført";"Nej"
"01.05.2012";"VDK USD     9,99";"-57,19";"18.857,12";"Udført";"Nej"
"01.05.2012";"VDK DKK    99,00";"-99,00";"18.758,12";"Udført";"Nej"
"01.05.2012";"VDK DKK    99,00";"-99,00";"18.659,12";"Udført";"Nej"
"01.05.2012";"VDK DKK    49,00";"-49,00";"18.610,12";"Udført";"Nej"
"01.05.2012";"VDK DKK    18,00";"-18,00";"18.592,12";"Udført";"Nej"
"01.05.2012";"VDK DKK    99,00";"-99,00";"18.493,12";"Udført";"Nej"
"01.05.2012";"onfone.dk          95042";"-99,00";"18.394,12";"Udført";"Nej"
"01.05.2012";"Irma Oslo Plads    73376";"-364,24";"18.029,88";"Udført";"Nej"
"01.05.2012";"Irma Oslo Plads    46894";"-80,00";"17.949,88";"Udført";"Nej"
"02.05.2012";"Automatudb. 3121-83 4170";"-500,00";"17.449,88";"Udført";"Nej"
"02.05.2012";"interflora.dk      15976";"-495,00";"16.954,88";"Udført";"Nej"
"03.05.2012";"FOCUS ØSTER FARIMA 32512";"-79,90";"16.874,98";"Udført";"Nej"
"03.05.2012";"PHOTOGRAFICA       07618";"-75,00";"16.799,98";"Udført";"Nej"
"03.05.2012";"Irma Nørre Voldg.  96683";"-170,50";"16.629,48";"Udført";"Nej"
"07.05.2012";"Vedels             86015";"-88,00";"16.541,48";"Udført";"Nej"
"07.05.2012";"KØBMANDSGÅRDEN     66988";"-650,04";"15.891,44";"Udført";"Nej"
"07.05.2012";"LISELEJE BAGEREN A 43830";"-69,50";"15.821,94";"Udført";"Nej"
"07.05.2012";"Fakta 392          87319";"-284,80";"15.537,14";"Udført";"Nej"
"07.05.2012";"LISELEJE BAGEREN A 43990";"-142,50";"15.394,64";"Udført";"Nej"
"07.05.2012";"LISELEJE BAGEREN A 40429";"-149,00";"15.245,64";"Udført";"Nej"
"07.05.2012";"Irma Oslo Plads    89539";"-433,00";"14.812,64";"Udført";"Nej"
"07.05.2012";"Q8 Service - 8020  16763";"-44,90";"14.767,74";"Udført";"Nej"
"07.05.2012";"Q8 Service - 8020  81023";"-406,50";"14.361,24";"Udført";"Nej"
"07.05.2012";"Klub - færge";"-200,00";"14.161,24";"Udført";"Nej"
"07.05.2012";"Automatudb. 3121-83 5494";"-600,00";"13.561,24";"Udført";"Nej"
"07.05.2012";"LABCPH             06282";"-1.000,00";"12.561,24";"Udført";"Nej"
"07.05.2012";"Lemontblanc        90485";"-98,00";"12.463,24";"Udført";"Nej"
"07.05.2012";"Illum              03606";"-224,50";"12.238,74";"Udført";"Nej"
"07.05.2012";"Irma Oslo Plads    09004";"-474,00";"11.764,74";"Udført";"Nej"
"07.05.2012";"Parkering Kbh IØ   22653";"-15,50";"11.749,24";"Udført";"Nej"
"08.05.2012";"VDK USD    24,70";"-142,16";"11.607,08";"Udført";"Nej"
"08.05.2012";"VDK DKK    29,00";"-29,00";"11.578,08";"Udført";"Nej"
"08.05.2012";"VDK DKK    12,00";"-12,00";"11.566,08";"Udført";"Nej"
"08.05.2012";"Dag H              53552";"-326,00";"11.240,08";"Udført";"Nej"
"08.05.2012";"McDonald's         55185";"-238,50";"11.001,58";"Udført";"Nej"
"09.05.2012";"Vedels             86893";"-60,00";"10.941,58";"Udført";"Nej"
"09.05.2012";"Vedels             86895";"-32,00";"10.909,58";"Udført";"Nej"
"09.05.2012";"Parkering Kbh IØ   18604";"-5,50";"10.904,08";"Udført";"Nej"
"09.05.2012";"Irma Codanhus 2301 94736";"-300,00";"10.604,08";"Udført";"Nej"
"09.05.2012";"Lemontblanc        90720";"-156,00";"10.448,08";"Udført";"Nej"
"09.05.2012";"Irma 23021         92408";"-139,50";"10.308,58";"Udført";"Nej"
"09.05.2012";"Avero ApS          34520";"-6.970,00";"3.338,58";"Udført";"Nej"
"10.05.2012";"Magasin";"-1.300,00";"2.038,58";"Udført";"Nej"
"10.05.2012";"MINIMARKED         80043";"-40,00";"1.998,58";"Udført";"Nej"
"10.05.2012";"Magasin, Kgs Nytor 31096";"-199,00";"1.799,58";"Udført";"Nej"
"10.05.2012";"FONA AFD. FS/110   18795";"-199,95";"1.599,63";"Udført";"Nej"
"10.05.2012";"Irma 23021         93103";"-313,50";"1.286,13";"Udført";"Nej"
"10.05.2012";"Ovf. tilbage";"9.000,00";"10.286,13";"Udført";"Nej"
"10.05.2012";"gentofteswim.dk    10875";"-1.250,00";"9.036,13";"Udført";"Nej"
"11.05.2012";"VDK DKK   169,00";"-169,00";"8.867,13";"Udført";"Nej"
"11.05.2012";"Vedels             87196";"-48,00";"8.819,13";"Udført";"Nej"
"11.05.2012";"Reinh. van Hauen   40420";"-99,01";"8.720,12";"Udført";"Nej"
"11.05.2012";"emmerys            49848";"-80,00";"8.640,12";"Udført";"Nej"
"11.05.2012";"Irma Codanhus 2301 94652";"-183,00";"8.457,12";"Udført";"Nej"
"11.05.2012";"altfortalt.dk      58508";"-101,25";"8.355,87";"Udført";"Nej"
"11.05.2012";"Gebr. Heinemann    49936";"-256,00";"8.099,87";"Udført";"Nej"
"11.05.2012";"Starbucks T2       81558";"-72,00";"8.027,87";"Udført";"Nej"
"11.05.2012";"SØSTJERNEN         20729";"-75,00";"7.952,87";"Udført";"Nej"
"11.05.2012";"Lemontblanc        91055";"-156,00";"7.796,87";"Udført";"Nej"
"11.05.2012";"Candy Megastore Sw 67339";"-139,00";"7.657,87";"Udført";"Nej"
"11.05.2012";"onfone.dk          37123";"-50,00";"7.607,87";"Udført";"Nej"
"14.05.2012";"VAISENHUS APOTEK   98679";"-312,00";"7.295,87";"Udført";"Nej"
"14.05.2012";"Hennes & Mauritz   29286";"-343,75";"6.952,12";"Udført";"Nej"
"14.05.2012";"A. BUSCK, KBH      76537";"-559,75";"6.392,37";"Udført";"Nej"
"14.05.2012";"Monsson Accessoriz 60379";"-188,80";"6.203,57";"Udført";"Nej"
"14.05.2012";"Holms bager        26983";"-67,00";"6.136,57";"Udført";"Nej"
"14.05.2012";"Magasin, Kgs Nytor 40584";"-549,00";"5.587,57";"Udført";"Nej"
"14.05.2012";"Hælebaren, City A/ 72977";"-75,00";"5.512,57";"Udført";"Nej"
"14.05.2012";"SuperB Borgergade  62972";"-466,20";"5.046,37";"Udført";"Nej"
"14.05.2012";"Monsson Accessoriz 59121";"135,20";"5.181,57";"Udført";"Nej"
"14.05.2012";"Hennes & Mauritz   69811";"-79,95";"5.101,62";"Udført";"Nej"
"14.05.2012";"FOCUS ØSTER FARIMA 37546";"-73,85";"5.027,77";"Udført";"Nej"
"14.05.2012";"DSB Kastrup AUT    44434";"-145,00";"4.882,77";"Udført";"Nej"
"14.05.2012";"Quick Silver       38823";"-950,00";"3.932,77";"Udført";"Nej"
"14.05.2012";"Monsoon Accessoriz 54098";"-307,00";"3.625,77";"Udført";"Nej"
"14.05.2012";"H&M Hennes & Mauri 64956";"-705,85";"2.919,92";"Udført";"Nej"
"14.05.2012";"Familieboden       09261";"-57,00";"2.862,92";"Udført";"Nej"
"14.05.2012";"Netto Sølvgade     34082";"-210,41";"2.652,51";"Udført";"Nej"
"14.05.2012";"Taxa 4 X 35        13603";"-257,00";"2.395,51";"Udført";"Nej"
"14.05.2012";"Irma Nørre Voldg.  87755";"-168,00";"2.227,51";"Udført";"Nej"
"14.05.2012";"Faraos Cigarer     68095";"-448,00";"1.779,51";"Udført";"Nej"
"14.05.2012";"Blockbuster Video  96502";"-108,00";"1.671,51";"Udført";"Nej"
"15.05.2012";"VDK DKK    24,00";"-24,00";"1.647,51";"Udført";"Nej"
"15.05.2012";"VDK EUR    16,50";"-123,89";"1.523,62";"Udført";"Nej"
"15.05.2012";"VDK DKK    40,00";"-40,00";"1.483,62";"Udført";"Nej"
"15.05.2012";"Dag H              57980";"-820,00";"663,62";"Udført";"Nej"
"15.05.2012";"Morten Holm        03021";"-69,00";"594,62";"Udført";"Nej"
"15.05.2012";"FONA AFD. FS/110   19345";"-369,95";"224,67";"Udført";"Nej"
"15.05.2012";"FOCUS ØSTER FARIMA 38633";"-66,75";"157,92";"Udført";"Nej"
"15.05.2012";"Irma Codanhus 2301 41760";"-63,00";"94,92";"Udført";"Nej"
"16.05.2012";"VDK DKK    35,00";"-35,00";"59,92";"Udført";"Nej"
"16.05.2012";"Reinh. van Hauen   41884";"-28,85";"31,07";"Udført";"Nej"
"16.05.2012";"Irma Oslo Plads    14028";"-308,50";"-277,43";"Udført";"Nej"
"16.05.2012";"H&M Hennes & Mauri 03287";"-388,95";"-666,38";"Udført";"Nej"
"17.05.2012";"Mathilde-Lommepenge";"-1.000,00";"-1.666,38";"Udført";"Nej"
"17.05.2012";"Ovf. tilbage";"5.000,00";"3.333,62";"Udført";"Nej"
"21.05.2012";"Vedels             88281";"-90,00";"3.243,62";"Udført";"Nej"
"21.05.2012";"FOCUS ØSTER FARIMA 39348";"-35,00";"3.208,62";"Udført";"Nej"
"21.05.2012";"Familieboden       09387";"-50,00";"3.158,62";"Udført";"Nej"
"21.05.2012";"KØBMANDSGÅRDEN     67611";"-653,75";"2.504,87";"Udført";"Nej"
"21.05.2012";"KØBMANDSGÅRDEN     89460";"-33,45";"2.471,42";"Udført";"Nej"
"21.05.2012";"DSB 7-Eleven Øster 65813";"-219,95";"2.251,47";"Udført";"Nej"
"21.05.2012";"LISELEJE BAGEREN A 08214";"-130,00";"2.121,47";"Udført";"Nej"
"21.05.2012";"Fakta 392          96750";"-133,10";"1.988,37";"Udført";"Nej"
"21.05.2012";"KØBMANDSGÅRDEN     89813";"-288,12";"1.700,25";"Udført";"Nej"
"21.05.2012";"Lisestuens Isbar   18692";"-113,00";"1.587,25";"Udført";"Nej"
"21.05.2012";"LISELEJE BAGEREN A 41073";"-115,50";"1.471,75";"Udført";"Nej"
"21.05.2012";"Paradis Tisvildele 14910";"-132,00";"1.339,75";"Udført";"Nej"
"21.05.2012";"FOCUS ØSTER FARIMA 40775";"-98,00";"1.241,75";"Udført";"Nej"
"21.05.2012";"PULCINELLA PIZZARI 41158";"-154,00";"1.087,75";"Udført";"Nej"
"21.05.2012";"Vedels             88883";"-64,00";"1.023,75";"Udført";"Nej"
"21.05.2012";"IRMA RYESGADE 60   94073";"-367,00";"656,75";"Udført";"Nej"
"21.05.2012";"altfortalt.dk      58997";"-101,25";"555,50";"Udført";"Nej"
"21.05.2012";"Ikea - 121, ECO    71032";"-524,00";"31,50";"Udført";"Nej"
"21.05.2012";"MCDONALD'S FAMILIE 41862";"-109,50";"-78,00";"Udført";"Nej"
"21.05.2012";"MCDONALD'S FAMILIE 41864";"-9,00";"-87,00";"Udført";"Nej"
"21.05.2012";"PIZZAHUSET         94580";"-50,00";"-137,00";"Udført";"Nej"
"21.05.2012";"Paradis Trianglen  57263";"-90,00";"-227,00";"Udført";"Nej"
"21.05.2012";"FOCUS ØSTER FARIMA 42098";"-51,95";"-278,95";"Udført";"Nej"
"22.05.2012";"VDK DKK   465,01";"-465,01";"-743,96";"Udført";"Nej"
"22.05.2012";"FONA AFD. FS/110   61794";"-199,95";"-943,91";"Udført";"Nej"
"22.05.2012";"Irma 23021         00578";"-431,00";"-1.374,91";"Udført";"Nej"
"22.05.2012";"Paradis Trianglen  57431";"-60,00";"-1.434,91";"Udført";"Nej"
"22.05.2012";"FOCUS ØSTER FARIMA 42552";"-18,95";"-1.453,86";"Udført";"Nej"
"23.05.2012";"VDK DKK    49,00";"-49,00";"-1.502,86";"Udført";"Nej"
"23.05.2012";"Magasin, Kgs Nytor 37449";"-350,00";"-1.852,86";"Udført";"Nej"
"23.05.2012";"Lemontblanc        92239";"-129,00";"-1.981,86";"Udført";"Nej"
"23.05.2012";"McDonald's         57284";"-143,50";"-2.125,36";"Udført";"Nej"
"23.05.2012";"SuperB Borgergade  88223";"-298,85";"-2.424,21";"Udført";"Nej"
"24.05.2012";"Irma Oslo Plads    03020";"-97,50";"-2.521,71";"Udført";"Nej"
"24.05.2012";"FOCUS ØSTER FARIMA 43611";"-51,00";"-2.572,71";"Udført";"Nej"
"25.05.2012";"Dankort PH 2100 0377720";"-122,95";"-2.695,66";"Udført";"Nej"
"25.05.2012";"Lemontblanc        92420";"-77,00";"-2.772,66";"Udført";"Nej"
"25.05.2012";"Lemontblanc        92432";"-30,00";"-2.802,66";"Udført";"Nej"
"25.05.2012";"Paradis Trianglen  17230";"-200,00";"-3.002,66";"Udført";"Nej"
"25.05.2012";"MATAS - 14788      48716";"-946,85";"-3.949,51";"Udført";"Nej"
"25.05.2012";"FRILUFTSLAND A/S   04803";"-299,00";"-4.248,51";"Udført";"Nej"
"25.05.2012";"Pico               71455";"-50,00";"-4.298,51";"Udført";"Nej"
"25.05.2012";"Pico               05184";"-150,00";"-4.448,51";"Udført";"Nej"
"25.05.2012";"MIN SØSTERS BUTIK  41857";"-504,00";"-4.952,51";"Udført";"Nej"
"25.05.2012";"Faraos Cigarer     84358";"-139,00";"-5.091,51";"Udført";"Nej"
"25.05.2012";"FOCUS ØSTER FARIMA 44231";"-91,95";"-5.183,46";"Udført";"Nej"
"25.05.2012";"PULCINELLA PIZZARI 41323";"-348,00";"-5.531,46";"Udført";"Nej"
"25.05.2012";"Irma Oslo Plads    96354";"-432,50";"-5.963,96";"Udført";"Nej"
"29.05.2012";"SUPERBEST          15033";"-105,45";"-6.069,41";"Udført";"Nej"
"29.05.2012";"Shell Service-1189 19203";"-398,20";"-6.467,61";"Udført";"Nej"
"29.05.2012";"Vedels             89730";"-108,00";"-6.575,61";"Udført";"Nej"
"29.05.2012";"Arnold Busck/ Hels 87845";"-399,80";"-6.975,41";"Udført";"Nej"
"29.05.2012";"IRMA HELSINGE      49144";"-580,00";"-7.555,41";"Udført";"Nej"
"29.05.2012";"Jysk               20392";"-299,00";"-7.854,41";"Udført";"Nej"
"29.05.2012";"Lisestuens Isbar   19304";"-82,00";"-7.936,41";"Udført";"Nej"
"29.05.2012";"KØBMANDSGÅRDEN     57157";"-146,43";"-8.082,84";"Udført";"Nej"
"29.05.2012";"Bake House         25616";"-49,00";"-8.131,84";"Udført";"Nej"
"29.05.2012";"Super Spar         46320";"-50,15";"-8.181,99";"Udført";"Nej"
"29.05.2012";"LISELEJE BAGEREN A 08762";"-114,00";"-8.295,99";"Udført";"Nej"
"29.05.2012";"onfone.dk          60156";"-25,00";"-8.320,99";"Udført";"Nej"
"29.05.2012";"KØBMANDSGÅRDEN     57506";"-198,40";"-8.519,39";"Udført";"Nej"
"29.05.2012";"Bake House         51121";"-30,00";"-8.549,39";"Udført";"Nej"
"29.05.2012";"FOCUS ØSTER FARIMA 45835";"-49,00";"-8.598,39";"Udført";"Nej"
"29.05.2012";"CDON AB            52826";"-39,00";"-8.637,39";"Udført";"Nej"
"29.05.2012";"Reinh. van Hauen   44694";"-30,00";"-8.667,39";"Udført";"Nej"
"29.05.2012";"Vedels             90183";"-48,00";"-8.715,39";"Udført";"Nej"
"29.05.2012";"cafe sari          55193";"-54,00";"-8.769,39";"Udført";"Nej"
"29.05.2012";"Irma Oslo Plads    96948";"-522,50";"-9.291,89";"Udført";"Nej"
"30.05.2012";"VDK USD     9,99";"-60,10";"-9.351,99";"Udført";"Nej"
"30.05.2012";"VDK DKK     6,00";"-6,00";"-9.357,99";"Udført";"Nej"
"30.05.2012";"VDK DKK     6,00";"-6,00";"-9.363,99";"Udført";"Nej"
"30.05.2012";"VDK DKK  2699,00";"-2.699,00";"-12.062,99";"Udført";"Nej"
"30.05.2012";"The Italian        20194";"-325,00";"-12.387,99";"Udført";"Nej"
"30.05.2012";"Irma Nørre Voldg.  99567";"-235,00";"-12.622,99";"Udført";"Nej"
"31.05.2012";"budget";"-20.000,00";"-32.622,99";"Udført";"Nej"
"31.05.2012";"VDK DKK    29,00";"-29,00";"-32.651,99";"Udført";"Nej"
"31.05.2012";"VDK DKK    99,00";"-99,00";"-32.750,99";"Udført";"Nej"
"31.05.2012";"Lønoverførsel";"31.537,14";"-1.213,85";"Udført";"Nej"
"31.05.2012";"Automatudb. 3121-83 1165";"-300,00";"-1.513,85";"Udført";"Nej"
"31.05.2012";"McDonald's         61083";"-177,00";"-1.690,85";"Udført";"Nej"
"31.05.2012";"Ovf. Juni 2012";"35.000,00";"33.309,15";"Udført";"Nej"
"31.05.2012";"Ovf. til Budget";"-4.000,00";"29.309,15";"Udført";"Nej"
"31.05.2012";"Lån til SP budget";"-15.000,00";"14.309,15";"Udført";"Nej"
"01.06.2012";"Vedels             90716";"-100,00";"14.209,15";"Udført";"Nej"
"01.06.2012";"onfone.dk          96287";"-99,00";"14.110,15";"Udført";"Nej"
"01.06.2012";"BYMAN CYKLERS EFTF 63894";"-915,00";"13.195,15";"Udført";"Nej"
"01.06.2012";"Lemontblanc        93288";"-186,00";"13.009,15";"Udført";"Nej"
"01.06.2012";"Player ApS         58302";"-150,00";"12.859,15";"Udført";"Nej"
"01.06.2012";"Nespresso Danmark  76377";"-1.099,00";"11.760,15";"Udført";"Nej"
"01.06.2012";"Candy Megastore Sw 73492";"-88,50";"11.671,65";"Udført";"Nej"
"01.06.2012";"FOCUS ØSTER FARIMA 48059";"-158,20";"11.513,45";"Udført";"Nej"
"02.06.2012";"Lommepenge";"-1.200,00";"10.313,45";"Udført";"Nej"
"02.06.2012";"Powertraining";"-600,00";"9.713,45";"Udført";"Nej"
"04.06.2012";"DANTAXI            02825";"-72,00";"9.641,45";"Udført";"Nej"
"04.06.2012";"JOE & THE JUICE    68660";"-710,00";"8.931,45";"Udført";"Nej"
"04.06.2012";"Superhelten v/Benj 00433";"-115,00";"8.816,45";"Udført";"Nej"
"04.06.2012";"Reinh. van Hauen   45954";"-90,88";"8.725,57";"Udført";"Nej"
"04.06.2012";"onfone.dk          28070";"-50,00";"8.675,57";"Udført";"Nej"
"04.06.2012";"Nordisk Film Bio   55046";"-196,65";"8.478,92";"Udført";"Nej"
"04.06.2012";"Irma Oslo Plads    41385";"-801,50";"7.677,42";"Udført";"Nej"
"04.06.2012";"McDonald's Nørrevo 57986";"-155,50";"7.521,92";"Udført";"Nej"
"04.06.2012";"Parkering Kbh KA   17374";"-10,50";"7.511,42";"Udført";"Nej"
"04.06.2012";"Vedels             91143";"-136,00";"7.375,42";"Udført";"Nej"
"04.06.2012";"TDC Yousee         96238";"-39,70";"7.335,72";"Udført";"Nej"
"04.06.2012";"TV 2/DANMARK       30966";"-19,00";"7.316,72";"Udført";"Nej"
"04.06.2012";"Taxa 4 X 35        08139";"-168,00";"7.148,72";"Udført";"Nej"
"04.06.2012";"SuperB Borgergade  73668";"-454,55";"6.694,17";"Udført";"Nej"
"04.06.2012";"SAS UDENRIGSGÅRDEN 08072";"-380,00";"6.314,17";"Udført";"Nej"
"04.06.2012";"SAS UDENRIGSGÅRDEN 08073";"-380,00";"5.934,17";"Udført";"Nej"
"06.06.2012";"VDK DKK   278,00";"-278,00";"5.656,17";"Udført";"Nej"
"06.06.2012";"Automatudb. 2104-3343";"-300,00";"5.356,17";"Udført";"Nej"
"06.06.2012";"Reinh. van Hauen   46695";"-144,80";"5.211,37";"Udført";"Nej"
"06.06.2012";"Lemontblanc        93647";"-146,00";"5.065,37";"Udført";"Nej"
"06.06.2012";"Blockbuster Video  34343";"-65,85";"4.999,52";"Udført";"Nej"
"06.06.2012";"FOCUS ØSTER FARIMA 50309";"-152,55";"4.846,97";"Udført";"Nej"
"06.06.2012";"sidewalkshop.dk     0391";"-579,00";"4.267,97";"Udført";"Nej"
"06.06.2012";"Bueskydning";"-550,00";"3.717,97";"Udført";"Nej"
"07.06.2012";"TDC Yousee         07639";"-39,70";"3.678,27";"Udført";"Nej"
"07.06.2012";"VDK DKK    39,00";"-39,00";"3.639,27";"Udført";"Nej"
"07.06.2012";"VDK DKK   683,50";"-683,50";"2.955,77";"Udført";"Nej"
"07.06.2012";"Meyers Deli A/S    13720";"-120,00";"2.835,77";"Udført";"Nej"
"07.06.2012";"Meyers Deli A/S    13734";"-80,00";"2.755,77";"Udført";"Nej"
"07.06.2012";"Faraos Cigarer     69618";"-2.095,00";"660,77";"Udført";"Nej"
"07.06.2012";"FOCUS ØSTER FARIMA 51173";"-101,95";"558,82";"Udført";"Nej"
"07.06.2012";"PULCINELLA PIZZARI 41677";"-152,00";"406,82";"Udført";"Nej"
"08.06.2012";"Automatudb. 6737-8836";"-1.200,00";"-793,18";"Udført";"Nej"
"08.06.2012";"Superhelten v/Benj 00841";"-510,00";"-1.303,18";"Udført";"Nej"
"08.06.2012";"Vinbørsen          62128";"-96,00";"-1.399,18";"Udført";"Nej"
"08.06.2012";"Reinh. van Hauen   47511";"-59,96";"-1.459,14";"Udført";"Nej"
"08.06.2012";"Shoots             35081";"-1.800,00";"-3.259,14";"Udført";"Nej"
"08.06.2012";"Lemontblanc        94036";"-206,00";"-3.465,14";"Udført";"Nej"
"08.06.2012";"The Bagel co.      20546";"-104,00";"-3.569,14";"Udført";"Nej"
"08.06.2012";"Candy Megastore Sw 75852";"-130,00";"-3.699,14";"Udført";"Nej"
"08.06.2012";"Ovf. tilbage";"15.000,00";"11.300,86";"Udført";"Nej"
"11.06.2012";"Automatudb. 3199-72 2377";"-1.500,00";"9.800,86";"Udført";"Nej"
"11.06.2012";"Hennes & mauritz   90269";"-198,00";"9.602,86";"Udført";"Nej"
"11.06.2012";"Parkering Kbh IØ   23429";"-20,50";"9.582,36";"Udført";"Nej"
"11.06.2012";"Vinspecialisten To 29562";"-55,00";"9.527,36";"Udført";"Nej"
"11.06.2012";"Parkering Kbh IB   21677";"-14,50";"9.512,86";"Udført";"Nej"
"11.06.2012";"FOCUS ØSTER FARIMA 51924";"-107,90";"9.404,96";"Udført";"Nej"
"11.06.2012";"McDonald's         15635";"-292,50";"9.112,46";"Udført";"Nej"
"11.06.2012";"Vedels             92353";"-100,00";"9.012,46";"Udført";"Nej"
"11.06.2012";"FOCUS ØSTER FARIMA 52351";"-117,20";"8.895,26";"Udført";"Nej"
"11.06.2012";"FOCUS ØSTER FARIMA 52541";"-65,95";"8.829,31";"Udført";"Nej"
"11.06.2012";"emmerys            58364";"-135,00";"8.694,31";"Udført";"Nej"
"11.06.2012";"Toscana Due        10851";"-129,00";"8.565,31";"Udført";"Nej"
"11.06.2012";"Implantatklinik Kø 06702";"-560,75";"8.004,56";"Udført";"Nej"
"11.06.2012";"ZISAR HARIDREZZER  12459";"-705,00";"7.299,56";"Udført";"Nej"
"11.06.2012";"Irma Oslo Plads    01092";"-804,00";"6.495,56";"Udført";"Nej"
"11.06.2012";"FOCUS ØSTER FARIMA 53369";"-69,95";"6.425,61";"Udført";"Nej"
"12.06.2012";"JOE & THE JUICE CP 13279";"-86,00";"6.339,61";"Udført";"Nej"
"12.06.2012";"Automatudb. 3121-83 4156";"-500,00";"5.839,61";"Udført";"Nej"
"12.06.2012";"Irma Fr.Borggade   78755";"-426,00";"5.413,61";"Udført";"Nej"
"12.06.2012";"Paradis Trianglen  60551";"-200,00";"5.213,61";"Udført";"Nej"
"13.06.2012";"VDK DKK    24,00";"-24,00";"5.189,61";"Udført";"Nej"
"13.06.2012";"VDK DKK   851,30";"-851,30";"4.338,31";"Udført";"Nej"
"14.06.2012";"Reinh. van Hauen   49028";"-38,95";"4.299,36";"Udført";"Nej"
"15.06.2012";"Vedels             93103";"-126,00";"4.173,36";"Udført";"Nej"
"15.06.2012";"Irma Østerbrog.52  94065";"-193,50";"3.979,86";"Udført";"Nej"
"17.06.2012";"Løn";"-580,00";"3.399,86";"Udført";"Nej"
"18.06.2012";"VDK DKK    30,00";"-30,00";"3.369,86";"Udført";"Nej"
"18.06.2012";"Vedels             93309";"-102,00";"3.267,86";"Udført";"Nej"
"18.06.2012";"FOCUS ØSTER FARIMA 55463";"-60,85";"3.207,01";"Udført";"Nej"
"18.06.2012";"PedalAtleten af 19 14843";"-349,00";"2.858,01";"Udført";"Nej"
"18.06.2012";"ParadIS Købmagerga 59784";"-200,00";"2.658,01";"Udført";"Nej"
"18.06.2012";"Faraos Cigarer     70254";"-211,00";"2.447,01";"Udført";"Nej"
"18.06.2012";"Dansk Shell - 1054 25947";"-618,85";"1.828,16";"Udført";"Nej"
"18.06.2012";"GAMES WORKSHOP     60480";"-30,00";"1.798,16";"Udført";"Nej"
"18.06.2012";"IRMA RYESGADE 60   21672";"-324,00";"1.474,16";"Udført";"Nej"
"18.06.2012";"Vedels             93523";"-48,00";"1.426,16";"Udført";"Nej"
"18.06.2012";"FOCUS ØSTER FARIMA 55953";"-17,00";"1.409,16";"Udført";"Nej"
"18.06.2012";"Bettina Beltner    26017";"-480,00";"929,16";"Udført";"Nej"
"18.06.2012";"emmerys            60384";"-84,00";"845,16";"Udført";"Nej"
"18.06.2012";"FOCUS ØSTER FARIMA 56562";"-174,75";"670,41";"Udført";"Nej"
"18.06.2012";"Irma Codanhus 2301 21382";"-92,00";"578,41";"Udført";"Nej"
"18.06.2012";"Irma Nørre Voldg.  15084";"-378,50";"199,91";"Udført";"Nej"
"18.06.2012";"FOCUS ØSTER FARIMA 56910";"-106,75";"93,16";"Udført";"Nej"
"19.06.2012";"Gebr. Heinemann    51818";"-199,00";"-105,84";"Udført";"Nej"
"19.06.2012";"McDonald's         66649";"-178,50";"-284,34";"Udført";"Nej"
"19.06.2012";"McDonald's         91897";"-51,00";"-335,34";"Udført";"Nej"
"20.06.2012";"FOCUS ØSTER FARIMA 57877";"-104,95";"-440,29";"Udført";"Nej"
"20.06.2012";"PULCINELLA PIZZARI 42131";"-204,00";"-644,29";"Udført";"Nej"
"21.06.2012";"Naturstyrelsen     46005";"-206,66";"-850,95";"Udført";"Nej"
"21.06.2012";"FOCUS ØSTER FARIMA 58210";"-62,95";"-913,90";"Udført";"Nej"
"21.06.2012";"Faraos Cigarer     70524";"-442,00";"-1.355,90";"Udført";"Nej"
"21.06.2012";"Irma Oslo Plads    30018";"-430,50";"-1.786,40";"Udført";"Nej"
"22.06.2012";"VDK EUR     8,99";"-67,52";"-1.853,92";"Udført";"Nej"
"22.06.2012";"Reinh. van Hauen   50802";"-35,40";"-1.889,32";"Udført";"Nej"
"22.06.2012";"Faraos Cigarer     70585";"-74,00";"-1.963,32";"Udført";"Nej"
"22.06.2012";"Irma Nørre Voldg.  86212";"-344,00";"-2.307,32";"Udført";"Nej"
"25.06.2012";"FOCUS ØSTER FARIMA 59231";"-70,90";"-2.378,22";"Udført";"Nej"
"25.06.2012";"FOCUS ØSTER FARIMA 59235";"-230,00";"-2.608,22";"Udført";"Nej"
"25.06.2012";"SILVAN             83105";"-381,57";"-2.989,79";"Udført";"Nej"
"25.06.2012";"SILVAN             23594";"-612,70";"-3.602,49";"Udført";"Nej"
"25.06.2012";"STOF 2000          65382";"-110,90";"-3.713,39";"Udført";"Nej"
"25.06.2012";"Spejder Sport A/S  96902";"-114,00";"-3.827,39";"Udført";"Nej"
"25.06.2012";"Vedels             94560";"-85,00";"-3.912,39";"Udført";"Nej"
"25.06.2012";"Magasin, Kgs Nytor 19381";"-479,40";"-4.391,79";"Udført";"Nej"
"25.06.2012";"Vedels             94667";"-122,00";"-4.513,79";"Udført";"Nej"
"25.06.2012";"FOCUS ØSTER FARIMA 59627";"-21,90";"-4.535,69";"Udført";"Nej"
"25.06.2012";"JORDEN RUNDT CAFE  63974";"-210,00";"-4.745,69";"Udført";"Nej"
"25.06.2012";"McDonald's         69531";"-292,50";"-5.038,19";"Udført";"Nej"
"25.06.2012";"Bibliotek";"-160,00";"-5.198,19";"Udført";"Nej"
"25.06.2012";"Statoil - 10750    30077";"-102,70";"-5.300,89";"Udført";"Nej"
"25.06.2012";"Statoil - 10750    80358";"-43,95";"-5.344,84";"Udført";"Nej"
"25.06.2012";"onfone.dk          78675";"-100,00";"-5.444,84";"Udført";"Nej"
"25.06.2012";"Faraos Cigarer     70819";"-60,00";"-5.504,84";"Udført";"Nej"
"25.06.2012";"LABCPH             07434";"-649,00";"-6.153,84";"Udført";"Nej"
"25.06.2012";"Irma Nørre Voldg.  20937";"-816,50";"-6.970,34";"Udført";"Nej"
"26.06.2012";"VDK DKK    18,00";"-18,00";"-6.988,34";"Udført";"Nej"
"26.06.2012";"VDK DKK    39,00";"-39,00";"-7.027,34";"Udført";"Nej"
"26.06.2012";"Reinh. van Hauen   51815";"-87,40";"-7.114,74";"Udført";"Nej"
"26.06.2012";"APOTEKET TRIANGLEN 22989";"-149,25";"-7.263,99";"Udført";"Nej"
"26.06.2012";"FONA AFD. FS/110   70856";"-249,95";"-7.513,94";"Udført";"Nej"
"26.06.2012";"MCS Copenhagen     14420";"-560,00";"-8.073,94";"Udført";"Nej"
"26.06.2012";"Nespresso Danmark  75021";"-309,00";"-8.382,94";"Udført";"Nej"
"26.06.2012";"North Face         52687";"-758,40";"-9.141,34";"Udført";"Nej"
"27.06.2012";"TDC Yousee         93857";"-39,70";"-9.181,04";"Udført";"Nej"
"27.06.2012";"VDK DKK    39,00";"-39,00";"-9.220,04";"Udført";"Nej"
"27.06.2012";"Reinh. van Hauen   52075";"-46,95";"-9.266,99";"Udført";"Nej"
"27.06.2012";"FOCUS ØSTER FARIMA 61298";"-58,00";"-9.324,99";"Udført";"Nej"
"27.06.2012";"Plaza Grill Og Piz 07442";"-100,00";"-9.424,99";"Udført";"Nej"
"27.06.2012";"Irma Oslo Plads    06028";"-664,50";"-10.089,49";"Udført";"Nej"
"27.06.2012";"FOCUS ØSTER FARIMA 61593";"-142,40";"-10.231,89";"Udført";"Nej"
"28.06.2012";"onfone.dk          66188";"-50,00";"-10.281,89";"Udført";"Nej"
"28.06.2012";"onfone.dk          66286";"-50,00";"-10.331,89";"Udført";"Nej"
"28.06.2012";"onfone.dk          70863";"-25,00";"-10.356,89";"Udført";"Nej"
"28.06.2012";"Nordisk Film Bio   45155";"-316,77";"-10.673,66";"Udført";"Nej"
"28.06.2012";"Shawarma ApS       83530";"-269,00";"-10.942,66";"Udført";"Nej"
"29.06.2012";"budget";"-20.000,00";"-30.942,66";"Udført";"Nej"
"29.06.2012";"PALADS TEATRET     31158";"-168,40";"-31.111,06";"Udført";"Nej"
"29.06.2012";"Lønoverførsel";"31.537,14";"426,08";"Udført";"Nej"
"29.06.2012";"Morten Holm        61361";"-87,00";"339,08";"Udført";"Nej"
"29.06.2012";"Ekstra ovf. budget";"-7.000,00";"-6.660,92";"Udført";"Nej"
"29.06.2012";"Ovf Jette løn";"33.000,00";"26.339,08";"Udført";"Nej"
"29.06.2012";"Lån til SP budget";"-17.500,00";"8.839,08";"Udført";"Nej"
"29.06.2012";"Irma Østerbrog.52  07660";"-153,50";"8.685,58";"Udført";"Nej"
"29.06.2012";"Rente";"3,68";"8.689,26";"Udført";"Nej"
"29.06.2012";"Rente";"-117,51";"8.571,75";"Udført";"Nej"
"29.06.2012";"Danske Ekstra-pakke";"-75,00";"8.496,75";"Udført";"Nej"